eginrsuvy : [surveying]
abbeiiilmprrttuy : [imperturbability]
adeertw : [watered]
adeertv : [averted]
ddegilnru : [ungirdled]
adeertt : [treated]
eeglnt : [gentle]
aegilnn : [leaning]
deelly : [yelled]
aegilnp : [leaping]
aaccilprt : [practical]
aegilnv : [leaving]
eeenpsx : [expense]
bcenorstu : [curbstone]
afggiimnny : [magnifying]
giinprrssu : [surprising]
acdeeers : [decrease]
clmpsu : [clumps]
aegluvy : [vaguely]
aegillv : [village]
elmst : [smelt]
aillv : [villa]
aerswy : [sawyer]
acelmnss : [calmness]
aeerrtt : [retreat]
cilnnoostuuy : [continuously]
aeeiiilnqstu : [inequalities]
akrst : [stark]
amyz : [mazy]
deeegrs : [degrees]
aaegilnnrtt : [alternating]
aacdiosuu : [audacious]
aadeegggrt : [aggregated]
efilny : [finely]
dghiin : [hiding]
einsstw : [witness]
cdeiinort : [direction]
eeilnrty : [entirely]
ehorty : [theory]
aegilnst : [stealing]
empty : [empty]
eeilllmv : [melville]
deelpy : [deeply]
knpsu : [spunk]
acggrsy : [scraggy]
abgrs : [grabs]
beghirstt : [brightest]
beiiiilopssst : [possibilities]
accceimnrsstu : [circumstances]
aegilnrt : [relating]
cceinnoopt : [conception]
eiqrsu : [squire]
eehnorssttuw : [southwestern]
adeenrrsw : [wanderers]
aeghinr : [hearing]
eerssttu : [trustees]
aeghinv : [heaving]
almnowy : [womanly]
ggiinnor : [ignoring]
dgiiinnty : [indignity]
ellnoow : [woollen]
efilst : [itself]
adeerrs : [readers]
bgiilnty : [bitingly]
cdeefilltuy : [deceitfully]
egilmnopy : [employing]
abceint : [cabinet]
defilptu : [uplifted]
hrsu : [rush]
ehorst : [others]
ehorss : [horses, shores]
bddenotuu : [undoubted]
ggiinnnr : [grinning]
aaciiinnopstt : [anticipations]
ehorsy : [horsey]
deelmt : [melted]
bckooopy : [copybook]
ehorsw : [shower]
efilrt : [trifle]
bbcdeefgiikllnnoru : [bullockbefriending]
aeghiln : [healing]
dersttu : [trusted]
ahlpss : [splash]
acdeemnopss : [encompassed]
ghinortw : [throwing]
eglosv : [gloves]
fllu : [full]
acnsty : [scanty]
aemrstt : [matters]
eilv : [veil, vile, evil, live]
deenrrs : [renders]
eilu : [lieu]
eilt : [tile]
efhirs : [fisher]
eils : [lies]
aemrstw : [warmest]
eilp : [pile]
dfin : [find]
aehlpsst : [pathless]
eiln : [line]
chilly : [chilly]
aegilrrru : [irregular]
floo : [fool]
flou : [foul]
deipprst : [stripped]
gorw : [grow]
flow : [fowl, flow]
aclmmy : [clammy]
elmno : [lemon]
eikn : [kine]
enstu : [tunes]
deelst : [eldest]
eikl : [like]
adeillrsttu : [illustrated]
acdehnst : [snatched]
dhlosu : [should]
hrtu : [hurt]
adegirttu : [gratitude]
giinntw : [twining]
demmrruu : [murmured]
einw : [wine]
ceginrsu : [securing]
ehnost : [honest]
abilrttuy : [brutality]
einp : [pine]
adeellnquu : [unequalled]
einn : [nine]
accelmmnoop : [commonplace]
adesty : [stayed, steady]
deemorv : [removed]
ceeinotux : [execution]
adestw : [wasted]
eimt : [time, item]
eimr : [rime]
eimn : [mine, mien]
giinrsuvv : [surviving]
aacdlns : [scandal]
bgiilnor : [broiling]
aeeilmnnst : [lineaments]
giinnru : [inuring]
amnoprsst : [sportsman]
dehirru : [hurried]
ceerss : [recess]
addeiinoppst : [disappointed]
eipw : [wipe]
adeswy : [swayed]
eipp : [pipe]
aeprs : [spare]
cdeeelst : [selected]
cdeiorsv : [discover]
aepry : [repay]
addeeprsu : [persuaded]
eehst : [these, sheet]
ceerst : [secret]
ceersu : [secure]
acehprt : [chapter]
hosstu : [shouts]
aceenrssy : [necessary]
adeimrr : [married]
acdeennrt : [entranced]
bdeilor : [broiled]
aaahlmnpst : [phantasmal]
aklnps : [planks]
eehrw : [where]
eehrt : [there, three]
ffginpu : [puffing]
aiilmntt : [militant]
deellry : [elderly]
eirw : [wire]
addejstu : [adjusted]
eirt : [rite]
eirs : [rise]
cdellnoort : [controlled]
dfoo : [food]
aerssu : [assure]
acdeiqru : [acquired]
acdemor : [comrade]
bddefor : [bedford]
aeemns : [seamen]
biilnoov : [oblivion]
aerstw : [waters]
eeelmrtxy : [extremely]
dfnu : [fund]
eeemrsttx : [extremest]
cdlloy : [coldly]
bginrstu : [bursting]
ccko : [cock]
dfno : [fond]
effinossu : [effusions]
eehtt : [teeth]
ddeefmor : [deformed]
efoopsstt : [footsteps]
aeegrrt : [greater]
acdehinnr : [hindrance]
eeehirss : [heresies]
fhlsu : [flush]
cceeeinnnov : [convenience]
aceinostu : [tenacious]
cdeffisu : [sufficed]
adeirrsuy : [residuary]
eeilmmnsy : [immensely]
eersstt : [streets]
addeffor : [afforded]
eisz : [size]
eisw : [wise]
ackkn : [knack]
adnno : [donna]
acdemn : [camden]
ceinorsux : [excursion]
aegilnopsttux : [expostulating]
bbinors : [ribbons]
adinty : [dainty]
ginnot : [noting]
hlloy : [holly]
aegnrrsst : [strangers]
cdgiiinnt : [indicting]
eeiqrru : [require]
acklo : [cloak]
ejnoruy : [journey]
eivw : [view]
eeisz : [seize]
cdeinort : [doctrine]
deikrst : [skirted]
deikrsu : [duskier]
addegln : [dangled]
aacilttuy : [actuality]
ackls : [slack]
cenoqru : [conquer]
aeeimmnt : [meantime]
abhit : [habit]
cddeeiprt : [predicted]
emrstyy : [mystery]
eeeglnt : [genteel]
cdeinors : [consider]
acdeot : [coated]
acghintw : [watching]
eghiimmnrs : [shimmering]
abceeelprst : [respectable]
acdeelmnoptt : [contemplated]
aabilnssttu : [substantial]
aabcilnn : [cannibal]
acehrs : [search, arches]
agilnpy : [playing]
aacchilmot : [catholicam]
hirstt : [thirst]
bdeefllosw : [bedfellows]
aadegnrr : [arranged]
abdettu : [abutted]
belmmoorru : [lumberroom]
anno : [anon]
aghikns : [shaking]
aceeissst : [ecstasies]
aopruv : [vapour]
acders : [scared, sacred]
acdert : [carted]
ehiprs : [perish]
acderv : [carved]
ccennor : [concern]
chikns : [chinks]
aagiilnnuv : [unavailing]
eenoprsss : [responses]
deotv : [voted]
aceillrs : [carlisle]
aceeehimntv : [achievement]
egoru : [rogue]
bkluy : [bulky]
eehorvw : [however, whoever]
ceeeissvx : [excessive]
eilstt : [titles]
agilnnp : [planing]
aeginpprr : [preparing]
filnty : [flinty]
acceelnrtu : [reluctance]
adghilty : [daylight]
cdelnostu : [consulted]
ceelmow : [welcome]
emorsuy : [seymour]
ceghhiinrs : [cherishing]
elmoorsy : [morosely]
bemors : [sombre]
lnoy : [only]
eosttu : [outset]
acdiijlu : [judicial]
ablorsu : [labours]
acdesu : [caused]
ceelmnt : [clement]
deenrsttu : [entrusted]
eeinr : [irene]
eiinqru : [inquire]
dinoww : [window]
lnny : [lynn]
aaegiiimntv : [imaginative]
ailrt : [trial]
egoos : [goose]
cnorw : [crown]
abbegl : [gabble]
blost : [bolts]
deghiilsst : [sidelights]
anry : [yarn]
eelrstt : [letters]
gilnoppt : [toppling]
eelmoprsy : [employers]
anrw : [warn]
cortu : [court]
aeiilmnptty : [impatiently]
acellry : [clearly]
aoprru : [uproar]
elrstu : [ulster, result]
acellrs : [cellars]
accinoos : [occasion]
bdelortu : [troubled]
ailst : [tails]
cdeejkoy : [jockeyed]
ehrtw : [threw]
ccoru : [occur]
acdeeilnpprru : [perpendicular]
deejoorvy : [overjoyed]
adeeeilnt : [delineate]
adeinrst : [strained]
ellmnosy : [solemnly]
acdees : [ceased]
aeinprst : [painters]
cdeeopr : [proceed]
bceeijstuv : [subjective]
aeinprss : [persians]
egilnorw : [lowering]
ailty : [italy]
antu : [aunt]
cnotu : [count]
acdehr : [arched]
acdehs : [chased]
ggiinnsw : [swinging]
aacdeknrs : [ransacked]
abenrz : [brazen]
eeehmorsw : [somewhere]
aeellntuvy : [eventually]
aghirs : [garish]
abenry : [nearby]
ellnosw : [swollen]
elrsuy : [surely]
aceiilmpst : [implicates]
ailtv : [vital]
acdehk : [hacked]
aeeemmnprtt : [temperament]
ccginnorsttu : [constructing]
abenru : [urbane]
adeillnu : [unallied]
antw : [want]
deorv : [drove, roved]
ahirt : [airth]
dghhilost : [lightshod]
ccdehltu : [clutched]
ggiinnrw : [wringing]
deknott : [knotted]
egopr : [grope]
deeehlw : [wheeled]
llorst : [stroll]
aehlnrtuy : [unearthly]
deeopprss : [oppressed]
ceimrs : [crimes]
aadehwy : [headway]
ddeehnorsu : [enshrouded]
eeflnqrtuy : [frequently]
cfinnoosu : [confusion]
deorr : [order]
bdenoy : [beyond]
ailns : [slain]
ailnt : [latin]
aailnnot : [national]
ailnp : [plain]
bilopssy : [possibly]
ccdeiopu : [occupied]
ccdeemmno : [commenced]
abchnr : [branch]
aeellpprtuy : [perpetually]
acehlp : [chapel]
ffgiinps : [spiffing]
deiqttu : [quitted]
accghint : [catching]
deooorsw : [rosewood]
aeelnprtv : [prevalent]
acdeiv : [advice]
definrs : [friends]
cdeoprru : [procured]
demopprt : [prompted]
iiorstv : [visitor]
aceellrssy : [carelessly]
ceeorrssu : [resources]
corss : [cross]
borstu : [robust]
acemopr : [compare]
aeimnrrs : [mariners]
acdell : [called]
acdelm : [calmed]
bginruy : [burying]
acdeln : [candle]
ailpr : [april]
acdelp : [placed]
aeghhiinstww : [whitewashing]
eeirrt : [retire]
acinnorstt : [constraint]
eeinrstt : [interest]
acdekp : [packed]
aceilprst : [particles]
aimnnostu : [mountains]
acdeks : [sacked]
bdeerttu : [buttered]
acdeeillty : [delicately]
ahint : [haint]
adghinosw : [shadowing]
eeirss : [series]
adinrw : [inward]
cilorsuuy : [curiously]
ceeilprsy : [precisely]
eeinrsuv : [universe]
eeefinrrt : [interfere]
cdeeorv : [covered]
deghilnorsu : [shouldering]
clmopy : [comply]
abcelllnnoortu : [uncontrollable]
epprsssu : [suppress]
acdeeghnx : [exchanged]
ellss : [sells]
allsuuy : [usually]
iilmt : [limit]
accdeimmnotu : [communicated]
aginsy : [saying]
agillmnu : [mulligan]
eoprstu : [spouter]
ersttu : [truest]
eiinorrt : [interior]
ddginpu : [pudding]
eillooprv : [liverpool]
deglorw : [growled]
ainqtu : [quaint]
aginrv : [raving]
ehossu : [houses]
ggiiimnssv : [misgivings]
cdeeeiprv : [perceived]
abeeiilmnst : [inestimable]
defilru : [direful]
aegllrruy : [regularly]
eeginpsw : [sweeping]
ddeenru : [endured]
adenorstuuv : [adventurous]
cddeennou : [denounced]
eeginorsv : [sovereign]
hirst : [shirt]
ceefhlru : [cheerful]
cemooprs : [composer]
korsw : [works]
iinnoop : [opinion]
aciillopt : [political]
aehinppss : [happiness]
aginpy : [paying]
eeilttx : [textile]
ddginno : [nodding]
cdefor : [forced]
aaddemrsy : [daydreams]
abelsty : [beastly]
deeiinoptx : [expedition]
emorw : [mower]
ceilss : [slices]
kortu : [turko]
dehilosuy : [hideously]
efhlttw : [twelfth]
emoss : [moses]
emosv : [moves]
aginrstt : [starting]
dgiiklnns : [kindlings]
ellps : [spell]
emost : [motes]
aginvw : [waving]
eeilnstt : [entitles]
ghinostu : [shouting]
diilv : [livid]
beefil : [belief]
abciimnnoost : [combinations]
knosw : [knows]
aeilnrstv : [intervals]
ellms : [smell]
cehirt : [thrice]
aginrssu : [assuring]
aachrrst : [catarrhs]
adeestw : [sweated]
cehirr : [richer]
aceehrs : [reaches]
aabcgiikllmn : [blackmailing]
ciiloorst : [solicitor]
beirtt : [bitter]
knost : [knots]
ahknst : [thanks]
fmor : [from, form]
diiot : [idiot]
bddegin : [bedding]
dlnnoo : [london]
bdelou : [double]
bdelot : [bolted]
ejko : [joke]
cdek : [deck]
cdei : [iced]
aeilnrsuv : [universal]
enrty : [entry]
giiknnst : [stinking]
deeeprrsv : [preserved]
adeghmnorrt : [grandmother]
addeginrss : [addressing]
hiknst : [thinks]
beirsu : [busier]
cdeeeiptv : [deceptive]
hstu : [shut, thus]
defilxy : [fixedly]
abiimostu : [ambitious]
alnotw : [walton]
cdekoor : [crooked]
ddegiklnnos : [goldskinned]
acins : [cains]
egnoruy : [younger]
chlnu : [lunch]
acinp : [panic]
cddeeiorsv : [discovered]
adeitttu : [attitude]
ceeellntx : [excellent]
aemrrst : [smarter]
ehinnssu : [sunshine]
aafiiilmrty : [familiarity]
ellssw : [swells]
aeqrrstu : [quarters]
eikrsst : [strikes]
hllowy : [wholly]
aclnry : [cranly]
deemnoy : [moneyed]
adlsy : [sadly]
eilmntuy : [minutely, untimely]
ddeghiiinsstu : [distinguished]
acddinorst : [discordant]
hiilmtuy : [humility]
eeegtt : [gettee]
aceknnttu : [nantucket]
mmnossu : [summons]
deehirtw : [withered]
cefinnooss : [confession]
egoprrss : [progress]
aeehlnvy : [heavenly]
aginpprst : [strapping]
chlot : [cloth]
eeeiqtttu : [etiquette]
dglo : [gold]
cdik : [dick]
aacrttt : [attract]
eeorrst : [restore]
adeeeprst : [desperate]
bceeinssstu : [subsistence]
begilnss : [blessing]
aertwy : [watery]
dgos : [dogs]
aeenrr : [nearer]
cdlo : [cold]
aeopr : [opera]
dgoo : [good]
adlmy : [madly]
aaddeiirrt : [irradiated]
fgiimnstyy : [mystifying]
ceorsss : [crosses]
ghhloortuy : [thoroughly]
eenprtv : [prevent]
cdgilnos : [scolding]
ceikrty : [rickety]
bcdeklo : [blocked]
deehiprsw : [whispered]
bcdeklu : [buckled]
adefiilnquu : [unqualified]
eghhinss : [highness]
aadehms : [ashamed]
giinort : [rioting]
eenprst : [present, serpent]
ikrsst : [skirts]
cddeeinors : [considered]
hmnost : [months]
acilm : [claim]
aqrtu : [quart]
aillnortuvy : [voluntarily]
bhrsu : [brush]
eenrst : [enters]
aceenrttu : [utterance]
eenrsv : [nerves]
aeeeilnrrtv : [reverential]
hmoruu : [humour]
iilmst : [limits]
ejsw : [jews]
ejst : [jest, jets]
eegrv : [verge]
aceoortv : [overcoat]
aeilrrty : [literary]
bdhiloorstty : [bloodthirsty]
denprsu : [spurned]
fggoy : [foggy]
eilmnoosst : [motionless]
befirs : [fibres]
beefor : [before]
acdeegnoru : [encouraged]
bbderu : [rubbed]
acdemmnors : [commanders]
acdeistt : [dictates]
adenstuy : [unsteady]
agiilnrt : [trailing]
cgikknno : [knocking]
deeennrsst : [tenderness]
eenqsu : [queens]
ahrrtu : [arthur]
eflopruw : [powerful]
adeinpt : [painted]
cdor : [cord]
bgilmntu : [tumbling]
hlloow : [hollow]
ccelloort : [collector]
agiilnsw : [wailings]
aaccinosstu : [accusations]
acehrry : [archery]
eeginnprtv : [preventing]
beeelnnotv : [benevolent]
ccdeorru : [occurred]
hmnot : [month]
aelrwy : [lawyer]
aeppr : [paper]
adeinst : [instead, stained]
rstuy : [rusty]
aghilrt : [alright]
agiilntv : [vigilant]
aacceinsv : [vacancies]
ddegilnu : [indulged]
addllnor : [landlord]
hotuy : [youth]
eeginnprst : [presenting]
giopss : [gossip]
ddegilnp : [peddling]
aceeilnnoqstu : [consequential]
abggy : [baggy]
aceitv : [active]
aahnnt : [nathan]
aadeh : [ahead]
rsttu : [trust]
adeinrt : [trained]
abeehiilnstux : [inexhaustible]
adeghlu : [laughed]
adffor : [afford]
aadegmn : [managed]
eehnpst : [stephen]
afmosu : [famous]
eorrrs : [errors]
efgimnoprr : [performing]
deiklswy : [dewsilky]
deiins : [inside]
aillprs : [pillars]
deiinv : [divine]
giimnruv : [virginum]
deeflrttu : [fluttered]
acgiiinnottx : [intoxicating]
agiklnt : [talking]
agiklnw : [walking]
loos : [solo]
loop : [pool]
loprty : [portly]
dgknoorruw : [groundwork]
eijnor : [rejoin, joiner]
eggiinnr : [reigning]
bemnru : [number]
emmory : [memory]
denru : [under]
beiilnnssy : [insensibly]
ahhrs : [harsh]
cghilorssst : [crosslights]
ddeiorrs : [disorder]
adeervyy : [everyday]
aghilnt : [halting]
aorr : [roar]
aghilnw : [whaling]
aghilnu : [hauling]
aacfmnortuy : [manufactory]
dekorw : [worked]
delruy : [rudely]
deijnru : [injured]
enoors : [sooner]
enpruy : [penury]
deimoprv : [improved]
deimoprt : [imported]
adeeeprt : [repeated]
deimoprs : [promised]
gnorst : [strong]
bddeeeimorr : [embroidered]
eehls : [heels]
enooss : [nooses]
ccenort : [concert]
deefinrr : [inferred]
acgimnsty : [gymnastic]
fghit : [fight]
orsst : [sorts]
aegillnrtv : [travelling]
denor : [drone]
ginnrtu : [turning]
denot : [noted]
cehils : [chisel]
aeeghlortt : [altogether]
denoz : [dozen]
loss : [loss]
ceenorsv : [converse]
losw : [slow]
ceilop : [police]
lost : [lost, lots]
losu : [soul]
bceorsu : [obscure]
cdeeiimn : [medicine]
bdemoo : [boomed]
orstw : [worst]
orsty : [story]
aeegllnry : [generally]
deersuvy : [surveyed]
kloo : [look]
aeginnoprst : [personating]
ceilnt : [client]
aabginr : [bargain]
aefnorttu : [fortunate]
cehins : [inches]
efimnorsstu : [misfortunes]
agiinssst : [assisting]
egnor : [negro]
abfflou : [buffalo]
cceorrt : [correct]
denps : [spend]
adgiijnno : [adjoining]
dggijnu : [judging]
aceilmrs : [miracles]
beggiinnn : [beginning]
deknnru : [drunken]
emnorsuu : [numerous]
ceeegiillnnt : [intelligence]
blntu : [blunt]
deehiinrt : [inherited]
aceghinnnt : [enchanting]
aeehilmnw : [meanwhile]
ddeenpu : [upended]
ehirrsu : [hurries]
altuv : [vault]
cdinooprtu : [production]
cejoprst : [projects]
egiinqruv : [quivering]
aeemrssu : [measures]
aaaceenppr : [appearance]
cehnpsu : [punches]
abdnoyy : [anybody]
aceeehimnstv : [achievements]
eeimprss : [premises]
klsu : [sulk]
adhiloy : [holiday]
acdeeinrs : [increased]
aelrsv : [slaver]
orsuy : [yours]
deeegmr : [emerged]
giklnoo : [looking]
deinorsssw : [drowsiness]
abiinorstv : [vibrations]
adhlry : [hardly]
aelrsy : [layers]
adeemnnort : [ornamented]
dehostu : [shouted]
blnow : [blown]
abgginn : [banging]
ceilms : [climes]
adeeilnpx : [explained]
accdehrst : [scratched]
acinnost : [contains]
aaeilnnoptx : [explanation]
aelrtt : [rattle, latter]
ckrstu : [struck]
ddeenow : [endowed]
aelrtv : [travel]
bgimnoo : [booming]
eegginrt : [greeting]
aaefginrs : [seafaring]
eeeinprrst : [enterprise]
diivv : [vivid]
cehostu : [touches]
adginr : [daring]
celoost : [coolest]
acdemopr : [compared]
adeempttt : [attempted]
agikmn : [making]
adeeppr : [papered]
eegnrt : [regent]
eoprtvy : [poverty]
eegnry : [energy]
dhitw : [width]
dgiinty : [dignity]
aeglsss : [glasses]
acdeeilnrst : [credentials]
knrtu : [trunk]
dgiinst : [tidings]
deenop : [opened]
agilnrsu : [singular]
deglnpu : [plunged]
deenot : [denote]
ceellmopty : [completely]
aeeforstt : [foretaste]
eiklnsy : [skyline]
aeillrsttu : [illustrate]
cdeiinrt : [indirect]
adepprt : [trapped]
ddefnou : [founded]
ainps : [pains]
ainpt : [paint]
adepprw : [wrapped]
abbehirs : [shabbier]
cekmory : [mockery]
dginot : [doting]
bgilnow : [blowing]
enorsstuu : [strenuous]
adeeprt : [tapered]
cekmors : [mockers]
cdeiinos : [decision]
egilnrstu : [resulting]
aabciilnnosstttuy : [consubstantiality]
kmosy : [smoky]
efinry : [finery]
dehiopprsw : [worshipped]
loops : [loops, sloop, spool]
ahknt : [thank]
adforrsw : [forwards]
accelrsy : [scarcely]
dhis : [dish]
cefor : [force]
eeeinstvx : [extensive]
ginoopst : [stooping]
addeest : [deadest]
mopprt : [prompt]
dilru : [lurid]
eeenrrt : [terrene]
efhilms : [himself]
knrstu : [trunks]
aacfiiilrt : [artificial]
eknw : [knew]
dgiinrv : [driving]
ceho : [echo]
aaaccrtt : [cataract]
deenrr : [render]
elosv : [loves]
eloss : [soles]
agilnrtt : [rattling]
deenru : [endure]
deenrt : [tender]
aabmnot : [boatman]
ddeelnpru : [plundered]
dhirt : [third]
ginprsuu : [pursuing]
eginors : [regions]
forty : [forty]
acdeeginrs : [decreasing]
cdeent : [decent]
elotw : [towel]
bcdeinou : [icebound]
agiknt : [taking]
adhinrtww : [withdrawn]
efgirsu : [figures]
agiknw : [waking]
fnort : [front]
iinnoops : [opinions]
ekpt : [kept]
deeilntvy : [evidently]
eklnt : [knelt]
chotu : [touch]
cefnoss : [confess]
bdeoorrw : [borrowed]
dilos : [solid]
aeemnsttt : [statement]
bcejstu : [subject]
alprty : [partly]
beioorsstu : [boisterous]
ekow : [woke]
ceiv : [vice]
dhlo : [hold]
cdeehiknt : [thickened]
cein : [nice]
addehosw : [shadowed]
ceil : [lice]
elorv : [lover]
elorw : [lower]
forst : [frost]
belss : [bless]
celt : [celt]
cdefinnot : [confident]
cell : [cell]
abiss : [basis]
eloos : [loose]
mmopsty : [symptom]
egglrrstu : [struggler]
beeerz : [breeze]
fhilty : [filthy]
emrry : [merry]
ceeehimnoprsv : [comprehensive]
dgiinnw : [winding]
abceklst : [blackest]
emrst : [terms]
aaghmr : [armagh]
cekn : [neck]
emrsu : [serum]
ceflt : [cleft]
aabeeeglr : [agreeable]
abcdkloow : [blackwood]
ceeptx : [except, expect]
aceiqru : [acquire]
deenprt : [pretend]
cdehipt : [pitched]
deffstu : [stuffed]
aceinnsst : [incessant]
chopr : [porch]
eefprrs : [prefers]
aabeellprsu : [pleasurable]
ceno : [once]
deehillrsv : [shrivelled]
moopstt : [topmost]
hnooru : [honour]
aeeiillrtt : [illiterate]
belno : [noble]
eeiimnosstt : [testimonies]
aafkk : [kafka]
bdilu : [build]
below : [elbow, below]
abins : [basin]
abinr : [brain]
dginru : [during]
cemo : [come]
ghinrsttu : [thrusting]
bceeilpsstu : [susceptible]
agiilnor : [original]
aerwy : [weary]
adoty : [today]
belos : [lobes]
eenstv : [events]
ceopprs : [coppers]
bdiln : [blind]
abekmrs : [embarks]
dilmy : [dimly]
dehlrswy : [shrewdly]
dehipps : [shipped]
aaeeginrtv : [vegetarian]
cepu : [puce]
aaflt : [fatal]
cdehinp : [pinched]
addeelp : [pleaded]
eemprt : [temper]
addeely : [delayed]
fghotu : [fought]
bbchu : [chubb]
cefhi : [chief]
ffgru : [gruff]
ceor : [core]
aclsw : [claws]
elnotvy : [novelty]
cepsstu : [suspect]
cefht : [fetch]
aclsy : [scaly]
acdekln : [clanked]
eelmpt : [temple]
aefilrsu : [failures]
ceeelopsst : [telescopes]
aceimsstty : [systematic]
aestt : [state, taste]
ceru : [cure]
acdeehiv : [achieved]
abeltt : [battle]
aestw : [waste]
cenostt : [contest]
aestv : [stave]
afhinos : [fashion]
eiooppst : [opposite]
eemorv : [remove]
aagin : [again]
ehirst : [theirs]
dhtu : [thud]
ehirsv : [shrive]
aellnoprsy : [personally]
acegostt : [cottages]
aforuv : [favour]
aemrtt : [matter]
aaeinopprrt : [preparation]
ceefilnnsu : [influences]
aceinnrsu : [insurance]
abjms : [jambs]
aceghinrs : [searching]
aeemrsu : [measure]
cenosvy : [conveys]
addeehr : [adhered]
aeemrst : [steamer]
aeopprv : [approve]
aceinnrtu : [uncertain]
abcghllou : [coughball]
deikpps : [skipped]
deeilmnoss : [solemnised]
beeeenrz : [ebenezer]
innou : [union]
deehiilnqrsu : [relinquished]
aeiimnptt : [impatient]
ceinnnott : [continent]
aacdeglnorttu : [congratulated]
brstu : [burst]
adegmnrsu : [guardsmen]
eorstv : [strove]
dllorwy : [worldly]
beelnoss : [boneless]
enoprs : [person]
nostu : [snout]
gikns : [kings]
deilmopr : [implored]
mstu : [must]
nosty : [stony]
aaadegnstv : [advantages]
eiilmss : [missile]
bsuy : [busy, buys]
apry : [pray]
aprt : [part, rapt, trap]
aprs : [spar]
eorsst : [stores]
aaeghnopr : [orphanage]
eeegmnrss : [messenger]
eekps : [keeps]
cdeelmopt : [completed]
mmrruu : [murmur]
adeersst : [asserted]
aaelllpr : [parallel]
deijno : [joined]
eiprsst : [persist]
ehorsuwy : [wheysour]
enoptt : [potent]
eeksw : [weeks]
aiorsuv : [various]
agikmns : [makings]
beostw : [bestow]
hlorsty : [shortly]
aceeffltu : [effectual]
cehikprsw : [shipwreck]
ilnosw : [wilson]
ginprs : [spring]
aadrstuy : [saturday]
anostw : [watson]
eiopstu : [piteous]
ahhrst : [thrash]
apss : [pass]
ainopss : [passion]
dejmpu : [jumped]
beeelst : [beetles]
aairstu : [austria]
begilnt : [belting]
deeghiinstux : [extinguished]
apsy : [pays]
giinnopt : [pointing]
apst : [past]
eikrst : [strike]
iorstuuv : [virtuous]
ahksy : [shaky]
eggimnr : [merging]
adegimnr : [dreaming]
abeforr : [forbear]
bdelnu : [bundle]
deinrrtu : [intruder]
deiinstuv : [unvisited]
deggilrw : [wriggled]
deeirrt : [retired]
aceeinrss : [increases]
cdeeho : [echoed]
eekls : [sleek]
efnot : [often]
cennoopru : [pronounce]
eekln : [kneel]
aefiortuv : [favourite]
ceikln : [nickel]
eemorstt : [remotest]
eeehlmsstv : [themselves]
deeirss : [desires]
cdeekp : [pecked]
aegiknps : [speaking]
acehllmnoy : [melancholy]
cginnnu : [cunning]
aacilpt : [capital]
efnrs : [ferns]
abelnu : [unable]
afghilns : [flashing]
mmopssty : [symptoms]
eknops : [spoken]
ekorst : [stroke]
eeinnoprss : [pensioners]
abdeknprtu : [bankrupted]
ciklquy : [quickly]
aachilm : [malachi]
deeeinprtux : [expenditure]
cginnos : [consign]
eekns : [knees]
abeiillrty : [liberality]
aceghilloot : [theological]
elllnsuy : [sullenly]
acefft : [affect]
delrstu : [rustled]
ainrt : [train]
aaclrs : [rascal]
bddeiloo : [bloodied]
aceilnor : [caroline]
ainry : [rainy]
aemrrw : [warmer]
deehorv : [hovered]
cmnoy : [comyn]
aeelprsu : [pleasure]
aeelprst : [prelates]
cdefnosu : [confused]
aghlu : [laugh]
adilms : [dismal]
defilrru : [flurried]
aimnoprtt : [important]
aaclsu : [casual]
aemrss : [smears]
ainsw : [swain]
aemrst : [master, stream]
beeeiilnprssx : [inexpressible]
adeeehnrtt : [threatened]
ainst : [saint, stain]
gilnops : [sloping]
aintw : [twain]
abgilnz : [blazing]
aadehirst : [stairhead]
acdemors : [comrades]
deefinr : [refined]
abelrt : [albert]
cddeemnno : [condemned]
abelrr : [barrel]
abelry : [barely]
abehlnooru : [honourable]
ddeeginstu : [undigested]
ccdeennot : [connected]
abeinrst : [banister]
aceeillst : [celestial]
adilns : [island]
eghlnty : [lengthy]
acdginprruuvw : [upwardcurving]
elnwy : [newly]
ainoop : [oinopa]
aeelrv : [reveal]
aeehrtw : [weather]
billnou : [bullion]
acilnnooost : [consolation]
fnnuy : [funny]
ddeelpr : [peddler]
fhiloos : [foolish]
aeelsv : [leaves]
aabcehilrt : [charitable]
agilns : [signal]
eeflry : [freely]
agilny : [laying]
aalnnrtuu : [unnatural]
ellt : [tell]
ells : [sell]
aeelpr : [repeal]
aeelps : [please, asleep]
bdegilo : [obliged]
ceiinst : [incites]
cdeeerrrstu : [resurrected]
foor : [roof]
cffu : [cuff]
ellw : [well]
foot : [foot]
aabefkrst : [breakfast]
efginr : [finger]
ceert : [erect]
ccdehoru : [crouched]
aehnrss : [harness]
eilnotv : [violent]
aehimpssty : [sympathise]
aeehrsw : [whereas]
diks : [disk]
elnt : [lent]
iinooprsv : [provision]
aeeinnoprtt : [penetration]
fgiilnt : [lifting]
dikn : [kind]
aefginr : [fearing]
deghiilns : [shielding]
aenrsstv : [servants]
aeeflrw : [welfare]
adeiimnnoppstt : [disappointment]
bdelosstu : [doubtless]
aadddeiilpt : [dilapidated]
effginrssu : [sufferings]
cceejnorstu : [conjectures]
elmo : [mole]
eilnovv : [involve]
abiillnrt : [brilliant]
cdeeeinrt : [intercede]
cdeeeinrs : [residence]
aabdekry : [daybreak]
aeglrty : [greatly]
eginnop : [opening]
eeelmnt : [element]
ehmort : [mother]
dgilmnou : [moulding]
abceelrr : [cerebral]
dimn : [mind]
abbees : [sabbee]
aghinv : [having]
aaerw : [aware]
eiprst : [tripes]
aeeltz : [teazle]
addefllruy : [dreadfully]
fost : [soft]
efgiru : [figure]
elov : [love]
efgirs : [griefs]
elot : [tole]
dils : [slid]
elos : [sole, lose]
elor : [role]
elop : [pole]
dilo : [idol]
dilm : [mild]
ceens : [scene]
aaegglnu : [language]
eghlnst : [lengths]
aglrttuu : [guttural]
abcehmr : [chamber]
aeglrru : [regular]
foru : [four]
ahmrtw : [warmth]
dilw : [wild]
bceeijotv : [objective]
bdlooy : [bloody]
elry : [rely]
diov : [void]
abghmoru : [brougham]
bcir : [crib]
elru : [lure, rule]
aaffir : [affair]
aaeeprst : [separate]
ceeip : [piece]
ackrt : [track]
acdeefhhiknr : [handkerchief]
belortu : [trouble]
dimosw : [wisdom]
abelostu : [absolute]
eefillrw : [freewill]
cdeiklt : [tickled]
acefins : [fancies]
dinw : [wind]
dint : [dint]
ceehk : [cheek]
cdeikln : [clinked]
acillnnotuy : [continually]
cdeehorstttu : [outstretched]
bcdeilm : [climbed]
enorsw : [owners]
ackss : [casks]
belorst : [lobster]
ceehr : [cheer]
aeegilntv : [elevating]
aciltty : [tacitly]
acdeehpr : [preached]
ehilstw : [whistle]
bcku : [buck]
ehllss : [shells]
aderst : [stared, trades]
ceekr : [creek]
belnost : [noblest]
cceeeiimnnrss : [reminiscences]
eiiinqrsu : [inquiries]
enortt : [rotten]
acenoopss : [spooncase]
efinrrtuu : [furniture]
aderry : [dreary]
aderrw : [reward]
acllmy : [calmly]
aeiimtt : [imitate]
elss : [less]
aaeinrrtv : [narrative]
cceeisssuv : [successive]
aadeehqrrstu : [headquarters]
aeenorrs : [reasoner]
aeehitvww : [wavewhite]
cgiklnpu : [plucking]
eefillss : [lifeless]
diknr : [drink]
dikns : [kinds]
acdeehrs : [searched]
bgiiklnn : [blinking]
aeegilnrv : [revealing]
giiknpps : [skipping]
bdeginn : [bending]
aabcdeirr : [barricade]
aacehnsss : [sassenach]
aceglns : [glances]
adfiilqsuy : [disqualify]
cennost : [consent]
aerrst : [arrest]
abdefilmor : [formidable]
acdelos : [seacold]
bceeiilm : [imbecile]
bdeeorvyy : [everybody]
ddeeen : [needed]
ddeeem : [deemed]
bclu : [club]
chiqstuy : [squitchy]
adeilpt : [plaited]
adeilps : [palsied]
acllor : [collar]
acdelps : [clasped]
adnry : [randy]
acdelpp : [clapped]
adnrw : [drawn]
agginprs : [grasping]
ddeefn : [defend]
eelnps : [spleen]
aceirrs : [carries]
acfloops : [foolscap]
eegrstu : [gesture]
chnpu : [punch]
adnst : [stand]
cdorsw : [crowds]
agiilmnp : [impaling]
aegrrv : [graver]
aceelnrss : [clearness]
bcehn : [bench]
adeeiilmmty : [immediately]
emmrsu : [summer]
cdeikns : [dickens]
ahimnnu : [inhuman]
hmotu : [mouth]
ceefn : [fence]
cennott : [content]
aahlnpst : [ashplant]
cddeopru : [produced]
eehistv : [thieves]
bdgllou : [bulldog]
aejmsty : [majesty]
ccklos : [clocks]
acdelns : [candles]
addeeeft : [defeated]
adgilnzz : [dazzling]
bekor : [broke]
acdeegorrrs : [gorescarred]
aekmrr : [remark]
adeilmp : [impaled]
eeilosstw : [stolewise]
aekmrt : [market]
acgijlno : [cajoling]
ddeein : [indeed]
acdemmr : [crammed]
aclls : [calls]
adimsy : [dismay]
aerrt : [arter]
iopsu : [pious]
abdeorrs : [boarders]
efgiorsw : [frogwise]
hmptu : [thump]
aadefrrstw : [afterwards]
biiilopssty : [possibility]
aerst : [stare, tears]
eeiqrrsu : [requires]
adeills : [sallied]
aersy : [years]
eelmry : [merely]
aersw : [wears]
eimnnooptt : [omnipotent]
aiorrtt : [traitor]
deikln : [linked]
giillnr : [rilling]
bells : [bells]
giinrtw : [writing]
ddeegw : [wedged]
deikll : [killed]
aertt : [treat]
aprst : [parts]
aefnnoort : [afternoon]
aertx : [extra]
eefgiln : [feeling, fleeing]
aertw : [water]
giillnw : [willing]
cginry : [crying]
aceeinpt : [patience]
ciinnstt : [instinct]
aprty : [party]
aclor : [coral, carol]
adeilnr : [ireland]
ipssw : [wisps]
efistty : [testify]
acdeeilt : [delicate]
ehissw : [wishes]
bhiosy : [boyish]
abeefflrsu : [sufferable]
bcegimno : [becoming]
aaegglnsu : [languages]
adoorwy : [doorway]
afgilnpp : [flapping]
ceenss : [scenes]
eeklmmopsu : [smokeplume]
cegghiimnnorstttu : [scrotumtightening]
cenoorstuuu : [uncourteous]
ddeemn : [mended]
aenorss : [reasons]
cddhhiloo : [childhood]
cdeilnppu : [unclipped]
cdiiinnostt : [distinction]
aghinsw : [washing]
ceenrs : [screen]
ceenrt : [recent, centre]
aacdelnps : [landscape]
ceenoptw : [twopence]
aagllnt : [gallant]
eghiinprsw : [whispering]
eehllsy : [shelley]
adhnostu : [thousand]
aanruwy : [runaway]
ddeenp : [depend]
know : [know]
knot : [knot]
ddeenw : [wended]
giinnnps : [spinning]
aghinrs : [sharing]
abdeegiilnrt : [deliberating]
agiimnnrtu : [ruminating]
eopprrty : [property]
aceeegnprt : [percentage]
deflloow : [followed]
aeelnrt : [eternal]
cdeellmop : [compelled]
aeelnrr : [learner]
beorrt : [robert]
aceeghnx : [exchange]
begggin : [begging]
ddmuy : [muddy]
deeimprtt : [permitted]
afgilnot : [floating]
abbhilsy : [shabbily]
dnorrssuu : [surrounds]
efmsu : [fumes]
aabdeimnot : [abominated]
bcilpu : [public]
cdeeeprst : [respected]
dillwy : [wildly]
acfgiiiinnnst : [insignificant]
emssty : [system]
ccddelnou : [concluded]
cfiiilnnot : [infliction]
elppru : [purple]
aeinpstt : [patients]
bdemoosy : [somebody]
aefhltu : [hateful]
aeenopprt : [notepaper]
abrssy : [brassy]
cdeeeprstu : [persecuted]
adeeflrtt : [flattered]
deefnost : [softened]
ddeerr : [redder]
knsu : [sunk]
abgggin : [bagging]
deilmnss : [mildness]
aceeeenprrsv : [perseverance]
abbginors : [absorbing]
cginopy : [copying]
acegil : [gaelic]
aaiinopprt : [apparition]
aceinnoorstv : [conversation]
aceghn : [change]
acdden : [danced]
aceghr : [charge]
ceeflrt : [reflect]
bdddeeim : [imbedded]
dhmmruu : [humdrum]
aegiimn : [imagine]
adehllnouw : [unhallowed]
adinstt : [distant]
adeehllpsw : [wellshaped]
aeglrvy : [gravely]
aaccdeimnop : [accompanied]
adeeilprv : [prevailed]
ceeeirv : [receive]
cosst : [costs]
aimpr : [prima]
eeinrtty : [eternity]
cddeemmno : [commended]
ceiprtu : [picture]
ahjno : [jonah]
aeiprss : [praises]
aceklmoos : [coalsmoke]
abbnrsuu : [suburban]
hirtty : [thirty]
aefgitu : [fatigue]
deglnou : [lounged]
acceennnotu : [countenance]
addenopr : [pardoned]
aeiprtv : [private]
acehiinssttu : [enthusiastic]
aemsss : [masses]
addeegilnnst : [disentangled]
aimss : [amiss]
acegln : [glance]
aeeeflrsstu : [featureless]
eefhlrs : [herself]
aadelnrstt : [translated]
acllops : [scallop]
aiprs : [paris, pairs]
ceersst : [secrets]
aaamnp : [panama]
aefinns : [fenians]
adeehstux : [exhausted]
abghilnosvw : [shavingbowl]
bnottu : [button]
diilqu : [liquid]
accdhhrruy : [churchyard]
nnoort : [norton]
abchikls : [blackish]
gijnnoorsu : [sojourning]
cddeeepr : [preceded]
cdeeegilnxy : [exceedingly]
aalmnu : [manual]
hjnnoy : [johnny]
flmnoruu : [mournful]
aceennrt : [entrance]
aeelnrtx : [external]
ceefhikr : [kerchief]
aadorwy : [roadway]
bder : [bred]
bden : [bend]
acimnprstu : [manuscript]
abeknoprrw : [pawnbroker]
cgiiknst : [sticking]
bdet : [debt]
acceilmopst : [complicates]
cdiinnoost : [conditions]
ehhirt : [hither]
abcmot : [combat]
eeimrttxy : [extremity]
ceefprt : [perfect]
afgls : [flags]
aabeeklmrr : [remarkable]
ddeeinw : [widened]
aefinrr : [refrain]
cehst : [chest]
adeggr : [ragged]
eiinnnott : [intention]
eginortw : [towering]
aacdehoppr : [approached]
eeimmosst : [sometimes]
aehippst : [happiest]
aadt : [data]
adeggj : [jagged]
emov : [move]
deeffor : [offered]
deegirv : [grieved]
eeimmnoprstv : [improvements]
cdffiiltu : [difficult]
emos : [some]
acehlrs : [charles]
cddeeett : [detected]
emor : [more]
cdeor : [cored]
emop : [mope]
abeinoorsstv : [observations]
cdeeeptx : [expected]
bdeelss : [blessed]
ailnps : [plains]
ailnpt : [pliant]
abdeelmtt : [embattled]
aintvy : [vanity]
eeinqu : [equine]
addeeprt : [departed]
acdeirr : [carried]
aghirstt : [straight]
bdis : [bids]
ddeeily : [yielded]
bdir : [bird]
cderu : [cured]
dgiilns : [sliding, sidling]
acmnopy : [company]
ddeeeilrv : [delivered]
aabilmot : [mailboat]
agilnppy : [applying]
acfiiln : [finical]
adegin : [gained]
eeinrt : [entire]
aaer : [area]
ejkrs : [jerks]
eghorru : [rougher]
ahmnu : [human]
deirrst : [stirred]
aaghlmn : [langham]
aafiillmry : [familiarly]
aafgorr : [farrago]
aeegnru : [uneager]
aademz : [amazed]
eghillnw : [wellnigh]
emtu : [mute]
cehos : [chose]
eikllntw : [wellknit]
deehlp : [helped]
acegiln : [angelic]
adeemrst : [streamed]
adeemrsu : [measured]
aabdelorrz : [razorblade]
ddeeirs : [desired]
ddensu : [sudden]
ddeeirv : [derived]
dinsw : [winds]
aeeiilmprtvy : [imperatively]
emsw : [mews]
cdehkos : [shocked]
aagr : [agra]
bdeghhinoooru : [neighbourhood]
acehlnn : [channel]
eikllnuy : [unlikely]
emmnost : [moments]
amoott : [tomato]
ddeeisv : [devised]
fghiilnorsu : [flourishing]
eghinrru : [hungrier]
aceeilmnopttv : [contemplative]
aelqrru : [quarrel]
aabcceilmmrtuu : [circumambulate]
deeilnrtu : [interlude]
aabceilnp : [incapable]
aabdnno : [abandon]
fghilt : [flight]
cinossst : [consists]
bhiiinooprt : [prohibition]
cdeilnrsy : [cylinders]
aadepr : [parade]
hmoost : [smooth]
cehpr : [perch]
bdlo : [bold]
cddefnnoou : [confounded]
cdegiknot : [docketing]
degnow : [gowned]
cceillnoot : [collection]
acdeilm : [medical]
bdoy : [body]
fgilny : [flying]
almost : [almost]
cmmnoo : [common]
adelrtt : [rattled]
aehirst : [hastier]
aeehnooprr : [harpooneer]
cceeillnoort : [recollection]
almort : [mortal]
aeeginottv : [vegetation]
ahhlrsy : [harshly]
epprsu : [supper]
ghortw : [growth]
deefnnostu : [unsoftened]
ceelrsuy : [securely]
cdeghou : [coughed]
aacekns : [askance]
ceeeirsv : [receives]
agiinrrv : [arriving]
ceeeirsx : [exercise]
ghiss : [sighs]
acfginny : [fancying]
eeeglnnsst : [gentleness]
ghist : [sight]
abceens : [absence]
ceelrsty : [secretly]
cfkor : [frock]
egiknnnost : [kensington]
adefnopr : [profaned]
ehmoosw : [somehow]
cdeir : [cried]
ddeeentx : [extended]
ghitt : [tight]
deemrttu : [muttered]
aiilmnrttuu : [rutilantium]
ghitw : [wight]
adeelost : [desolate]
ablor : [labor]
acehprsu : [purchase]
deeginntx : [extending]
ghosst : [ghosts]
ceoprss : [process, corpses]
adeknrss : [darkness]
ceoprru : [procure]
belrstu : [butlers]
aaciinoosst : [association]
aiinnnoostt : [intonations]
cdeklo : [locked]
acost : [coast, coats]
mnoorsstu : [monstrous]
aegiiinnosttv : [investigation]
cgilnos : [closing]
cdhhiils : [childish]
adddeemn : [demanded]
ddeeenrr : [rendered]
aadeiprs : [paradise]
bcikr : [brick]
ijlsuu : [julius]
addeeenorv : [endeavored]
aeghilmnns : [englishman]
cdekor : [rocked]
aadegm : [damage]
adeeerrtt : [retreated]
enrsuu : [unsure]
eegiinnrstt : [interesting]
beors : [sober]
bcilm : [climb]
arty : [tray]
aaiimnnot : [animation]
bdloo : [blood]
aeehmnnop : [phenomena]
cehnos : [chosen]
eeersv : [severe]
abdeeilprstu : [disreputable]
elnssu : [unless]
demnotu : [mounted]
adeeginnoruv : [endeavouring]
ghostu : [sought]
abinot : [obtain]
inpst : [pints]
abghiopry : [biography]
arsy : [rays]
koot : [took]
ceoprtt : [protect]
adefry : [frayed]
abceesu : [because]
arst : [arts, star]
deeeinprrtt : [interpreted]
oprsu : [pours]
giilmns : [smiling]
giinstt : [sitting]
efgrsu : [fergus]
demppu : [pumped]
beeirrs : [berries]
dghlnoorst : [stronghold]
arvy : [vary]
jlow : [jowl]
korw : [work]
adeftw : [wafted]
aeeilnnttu : [lieutenant]
ablls : [balls]
ceeorrsu : [resource]
achilpsy : [physical]
ghiinppw : [whipping]
aorrz : [razor]
effort : [effort]
ceegiinrv : [receiving]
ablmy : [balmy]
adrsy : [yards]
admnoy : [monday]
acehimpstty : [sympathetic]
abinrs : [brains]
aeelmpx : [example]
acknpu : [unpack]
aghiinnosst : [astonishing]
aaelnpst : [pleasant]
efffiitvy : [fiftyfive]
abginossvx : [savingsbox]
ilopst : [pistol]
ginnprsu : [spurning]
acciimmnnootu : [communication]
eiklly : [likely]
behorrt : [brother]
hoosst : [shoots]
ceffios : [offices]
ceffior : [officer]
acnorstt : [contrast]
cddeeeiv : [deceived]
aeeglmnnt : [gentleman]
ceiorsw : [cowries]
adefil : [failed]
ceeinssty : [necessity]
acelpr : [parcel]
acelps : [places]
cehlost : [clothes]
bginnru : [burning]
cdektu : [tucked]
adeeeknw : [weakened]
belorstu : [troubles]
aawy : [away]
abdeelmm : [embalmed]
diosstuu : [studious]
aehilw : [awhile]
eilopt : [polite]
eimrsy : [misery]
eimrst : [mister, mitres, merits]
delmos : [seldom]
acelss : [scales]
acelst : [castle]
cdeehrstt : [stretched]
einoqstu : [question]
deeiillmpr : [imperilled]
gnprsu : [sprung]
ccellot : [collect]
eemss : [seems]
jluy : [july]
ddeimnostu : [dismounted]
ehknnrsu : [shrunken]
fistw : [swift]
adirvz : [vizard]
aekrst : [streak]
ehjops : [joseph]
beefint : [benefit]
abbirt : [rabbit]
addeeenoruv : [endeavoured]
adhosw : [shadow]
cdeopru : [produce]
ehilrs : [relish]
abeellnruv : [vulnerable]
aderstt : [started]
aeilry : [airley]
bceinorsttu : [contributes]
cgilnru : [curling]
egssu : [guess]
aceennsstu : [sustenance]
adeemnprtt : [department]
adegilnos : [alongside]
efgilnoorsvw : [overflowings]
adefmr : [framed]
aellmort : [martello]
aderssu : [assured]
aceltt : [cattle]
cehnqu : [quench]
aceilpru : [peculiar]
aeilsy : [easily]
aeilsv : [valise]
deefgin : [feeding]
ehilsw : [whiles]
giltuy : [guilty]
fisst : [fists]
deeipss : [despise]
deeipst : [despite]
cefhnr : [french]
eeenssstw : [sweetness]
ghhortu : [through]
aaefiimnnostt : [manifestation]
aciipttvy : [captivity]
aceffst : [affects]
ceinooprsss : [processions]
eiklns : [silken]
adfiry : [friday]
ailqtuy : [quality]
eiklnu : [unlike]
eemny : [enemy]
befilry : [briefly]
aehins : [haines]
egstu : [guest]
ddeenorsu : [resounded]
booopstt : [topboots]
doprs : [drops]
adeefnst : [fastened]
aflorv : [flavor]
aclmmnooty : [commonalty]
dopru : [proud]
been : [been]
beiilmopss : [impossible]
enno : [none]
beef : [beef]
bhlmuy : [humbly]
abby : [baby]
aaiilnst : [italians]
biklrsy : [briskly]
ffooortty : [fortyfoot]
aagiiimnnot : [imagination]
beer : [beer]
bees : [bees]
gghilssu : [sluggish]
giknorst : [stroking]
iinosv : [vision]
aegimnst : [steaming]
abetuy : [beauty]
ddeennoru : [underdone]
bchoor : [brooch]
giinqrstu : [squirting]
deglnorssu : [groundless]
bkoos : [books]
enpt : [pent]
abdr : [drab, bard]
eenrtuv : [venture]
abdl : [bald]
acenos : [canoes]
iiprsst : [spirits]
begi : [gibe]
aegimnrt : [emigrant]
eiiopstv : [positive]
abde : [bade]
eejrst : [jester]
ceorsu : [course]
eejrsy : [jersey]
ceorss : [scores]
chir : [rich]
enot : [note, eton, tone]
enos : [nose, ones]
deeintv : [evident]
abck : [back]
chin : [chin]
enop : [open]
aeilnrtv : [interval]
cceiopsu : [occupies]
abcs : [cabs]
aersttt : [tatters]
chit : [itch]
afissty : [satisfy]
enrt : [rent]
beil : [bile]
dehrsu : [rushed]
deegilnr : [lingered]
dehrsw : [shrewd]
aaceirsst : [staircase]
cdeersw : [screwed]
adgnor : [dragon]
adehil : [hailed]
cdeersu : [secured, rescued]
abes : [base]
aber : [bear, bare]
abem : [beam]
deelmnopuy : [unemployed]
abel : [able]
ahiimnrs : [irishman]
bdiosuu : [dubious]
ailors : [sailor]
bddgoosy : [dogsbody]
abdeeeillrty : [deliberately]
cdemoops : [composed]
abet : [beat]
eehlpr : [helper]
bcillpuy : [publicly]
bdeeeemmrr : [remembered]
entx : [next]
entw : [went]
entu : [tune]
celopsu : [couples]
eeginy : [eyeing]
aaegtwy : [gateway]
addehs : [dashed, shaded]
addehn : [handed]
eegins : [seeing]
ensw : [news]
chmu : [much]
enst : [sent, nest]
acenrv : [craven]
deisttw : [twisted]
ahlls : [shall]
eflruu : [rueful]
aadegitt : [agitated]
ahnorrstw : [arnsworth]
bcdeeirs : [describe]
envy : [envy]
eegmnst : [segment]
elpst : [slept]
ceijstu : [justice]
bdeeinot : [obedient]
eirrsv : [rivers]
eehlsw : [wheels]
bioosuv : [obvious]
efgnoortt : [forgotten]
adeelprs : [relapsed]
aeervw : [weaver]
deefghinrt : [frightened]
belw : [blew]
belu : [blue]
bell : [bell]
afilnty : [faintly]
eirrtw : [writer]
eegnorsu : [generous]
cdisssu : [discuss]
beoy : [obey]
beor : [bore]
adeeelprty : [repeatedly]
deflow : [flowed]
abll : [ball]
giillnps : [spilling]
adhorstuw : [southward]
cceeins : [science]
dimst : [midst]
bent : [bent]
abkn : [bank]
eiloprsu : [perilous]
beno : [bone]
dgiinv : [diving]
ekmos : [smoke]
elpry : [reply]
aegstuv : [gustave]
aceefhnrrtu : [furtherance]
ehpryz : [zephyr]
bdilnu : [dublin]
bfilmru : [brimful]
deeirs : [desire]
bdilns : [blinds]
deeirv : [derive]
cenorr : [corner]
aggiilnoops : [apologising]
aaginst : [against]
aainqsu : [aquinas]
deegklnow : [knowledge]
ddeeillps : [dispelled]
aaadeimnnt : [adamantine]
giknnott : [knotting]
agginnor : [groaning]
affhilltuy : [faithfully]
aegiknqsu : [squeaking]
ghiltty : [tightly]
aadginrsu : [guardians]
aeehrtvw : [whatever]
cdlosu : [clouds]
clmsuy : [clumsy]
chsu : [such]
deflty : [deftly]
dksuy : [dusky]
ggilnory : [glorying]
best : [best]
aagnp : [pagan]
aacdgijllmtuy : [judgmatically]
abellorty : [tolerably]
abot : [boat]
cmostu : [custom]
dellorst : [strolled]
adeekmrr : [remarked]
eehilosttu : [silhouette]
ceeenprs : [presence]
deeivw : [viewed]
abry : [bray]
ffist : [stiff]
cdhimnor : [richmond]
bcdegiinrs : [describing]
adnnstu : [dunstan]
ehillmw : [wilhelm]
bddelnotuuy : [undoubtedly]
astv : [vast]
iloqru : [liquor]
asty : [stay]
aeglnprs : [grapnels]
eggsstu : [suggest]
cdeeeffinr : [difference]
cgiklno : [locking]
ffity : [fifty]
adegrr : [regard]
iorvy : [ivory]
assy : [says]
aceefilpr : [fireplace]
einnrsw : [winners]
ghirt : [right]
benor : [borne]
benos : [bones]
ggggilno : [goggling]
aeenrst : [earnest, nearest]
asss : [sass]
aadfir : [afraid]
cehimrsty : [chemistry]
cgnoo : [congo]
cehin : [niche]
ceinoppru : [porcupine]
oorrssw : [sorrows]
eeqrstu : [request]
ceinntv : [vincent]
enorsuv : [nervous]
gilrs : [girls]
aaelnprrstuu : [supernatural]
deeoprrt : [reported]
hlost : [sloth]
deeenosttw : [sweettoned]
dginnopu : [pounding]
acnst : [scant]
dginorsw : [drowsing]
aabbeilmno : [abominable]
aempsttt : [attempts]
deeisz : [seized]
cdeeu : [deuce]
lstu : [lust]
acceehirrttu : [architecture]
cdeinot : [noticed]
aghilnpty : [plaything]
eelst : [steel]
ijno : [join]
ghimt : [might]
inopt : [point]
eeopru : [europe]
aceefllpuy : [peacefully]
giimnnoot : [motioning]
eeoprs : [repose]
aacilprrtu : [particular]
acceilmmor : [commercial]
dhinoorssu : [dishonours]
afilnpu : [painful]
aeersv : [averse]
ghint : [thing, night]
abdeloru : [laboured]
ellnuw : [unwell]
aellstt : [tallest]
inoor : [orion]
ehrssttu : [shutters]
jmpu : [jump]
aswy : [ways, sway]
acnno : [conan]
gilny : [lying]
gilnt : [glint]
deilpps : [slipped]
deorrttu : [tortured]
abkln : [blank]
ghilt : [light]
aceeillnoptxy : [exceptionally]
adeirssst : [disasters]
bddefinor : [forbidden]
aaccillnoosy : [occasionally]
ellnsu : [sullen]
aghiknnt : [thanking]
behorrst : [brothers]
belott : [bottle]
abceefnort : [benefactor]
cirstu : [rustic]
aaelmnss : [salesman]
aceeillpsy : [especially]
eforz : [froze]
adggginr : [dragging]
cirstt : [strict]
ddeeeimnrt : [determined]
doost : [stood]
cehklors : [sherlock]
aeegilnrstv : [everlasting]
fglnu : [flung]
fhort : [forth]
hoorrr : [horror]
acemrs : [scream]
ccdehiln : [clinched]
giknnostw : [kingstown]
aeegiinnnrtt : [entertaining]
doors : [doors]
hillrs : [shrill]
dooru : [odour]
ahlmnot : [lothman]
cceinoorrst : [corrections]
eilprs : [perils]
aceghinrtt : [chattering]
aeginnors : [reasoning]
dginoprrtu : [protruding]
aeimnt : [inmate]
aeimnr : [remain]
eimrssst : [mistress]
floorrsuw : [sorrowful]
adeimnrru : [unmarried]
fhoos : [hoofs]
adeglz : [glazed]
acgimnopr : [comparing]
aissst : [assist]
cdelmpru : [crumpled]
eelps : [sleep]
adginrw : [drawing]
adginrt : [trading]
ccehilnor : [chronicle]
first : [first]
aginr : [grain]
derss : [dress]
aoottt : [tattoo]
aceorrt : [creator]
cefhiims : [mischief]
aeggilnrtu : [regulating]
abcdegir : [birdcage]
cdeiiilnps : [discipline]
aeelmnss : [nameless, salesmen]
deilmttuu : [multitude]
chnotuu : [uncouth]
acegilnnnou : [uncongenial]
aeeilmns : [milanese]
adegnw : [gnawed]
ceiprs : [prices]
acdeehoprr : [reproached]
adegnr : [garden, ranged, danger]
deehlnt : [lendeth]
agnprs : [sprang]
adeenry : [yearned]
ehimrt : [hermit]
aceeelnrssss : [carelessness]
aeimrs : [armies]
eelmm : [lemme]
lprssuu : [surplus]
aeehorstvw : [whatsoever]
accilmo : [comical]
eelsssu : [useless]
adegilns : [dealings]
aeghopprrss : [grasshopper]
aeehlstt : [stealeth]
aabdginnno : [abandoning]
eellv : [level]
aehjpt : [japhet]
eeflrru : [ferrule]
adeeelrs : [released]
deghnorsu : [horsedung]
eopt : [poet]
enorrtuv : [turnover]
eopp : [pope]
acdi : [acid]
ceimmooprs : [compromise]
ccilnnoosu : [conclusion]
deeeenprrst : [represented]
bdegimoorr : [bridegroom]
aadeelllnpru : [unparalleled]
acdr : [card]
aagiinott : [agitation]
ghistt : [tights]
ddeissu : [disused]
deeimpt : [emptied]
cdeeginors : [recognised]
eginopsx : [exposing]
iiprst : [spirit]
agginp : [gaping]
afint : [faint]
ceeeiprv : [perceive]
deiinnsstu : [untidiness]
agginz : [gazing]
dllu : [dull]
deffhlsu : [shuffled]
eorw : [wore]
dlou : [loud]
eorv : [over]
acdehillmoty : [methodically]
dlot : [told]
dlos : [sold]
eort : [tore]
dlor : [lord]
eors : [rose, sore]
aeflm : [flame]
cilo : [coil]
iinossv : [visions]
deeefrtt : [fettered]
aefls : [false]
ekooprv : [provoke]
dorss : [dross]
agillnrsuy : [singularly]
acft : [fact]
dnopu : [pound]
dorsw : [words, sword]
adeehhinstuww : [unwhitewashed]
ciks : [sick]
acep : [cape, pace]
aefmr : [frame]
ahlrsy : [rashly]
aglss : [glass]
acer : [care, race]
cikp : [pick]
acem : [came]
cikk : [kick]
aceh : [each]
cikl : [lick]
efginor : [foreign]
aeginrvw : [wavering]
acef : [face]
aaegimnz : [magazine]
elorsst : [ostlers]
aacgillrty : [tragically]
aces : [case]
adderss : [address]
acht : [chat]
aabcdkrw : [backward]
achp : [chap]
adhrstuy : [thursday]
defmor : [formed]
cghiiklnopttt : [thickplotting]
cino : [coin]
ehpssu : [pushes]
acnnostt : [constant]
cdenors : [scorned]
bceeehiilmnnoprs : [incomprehensible]
abeflrtu : [flaubert]
eilpprs : [slipper]
eflsuu : [useful]
eosw : [owes, woes]
eemmnotv : [movement]
eost : [toes]
abeegint : [agenbite]
ceeirssv : [services]
deejkr : [jerked]
deisstu : [studies]
aceehhirrs : [heresiarch]
agiklnnr : [rankling]
aaddeeipprs : [disappeared]
eehllpss : [helpless]
aglno : [along]
ghisst : [sights]
cefflsu : [scuffle]
billy : [billy]
ainrst : [strain, trains]
adehmnos : [handsome]
accdeklr : [crackled]
cdeorss : [crossed]
bills : [bills]
ccddeeesu : [succeeded]
aeghlrtu : [laughter]
cehinrss : [richness]
ehnnorrt : [northern]
afiln : [final]
aeggginn : [engaging]
ciov : [vico]
aeeehmrrrtwy : [merryweather]
abdnry : [brandy]
cdeeginopr : [proceeding]
afilr : [frail]
iistv : [visit]
aacfinorssttuy : [unsatisfactory]
eehinrt : [neither]
aceklt : [tackle]
acdegln : [glanced, clanged]
bilms : [limbs]
aeeglnr : [general]
acly : [clay]
accinoopstu : [occupations]
dluy : [duly]
addeinor : [ordained]
aclm : [calm]
cceginnnor : [concerning]
acll : [call]
beinsssu : [business]
blmoosss : [blossoms]
gopru : [group]
ceeehirst : [cheeriest]
flosty : [softly]
ceehinnort : [incoherent]
acks : [cask]
ackp : [pack]
aeqrsu : [square]
ackl : [lack]
cchhru : [church]
adorru : [ardour]
egimnnoorry : [ironmongery]
abcgikn : [backing]
ceeginprst : [respecting]
city : [city]
aahpstwy : [pathways]
giimmnrt : [trimming]
aeeelstv : [elevates]
eeilopprssvy : [oppressively]
eirsst : [sister]
abilru : [burial]
adnoru : [around]
aceelmnoptt : [contemplate]
adortw : [toward]
bdeegilu : [beguiled]
acdeghn : [changed]
beegiill : [eligible]
denrssu : [undress]
bdeegiln : [bleeding]
defhiinprs : [friendship]
eirstw : [writes]
eillnssst : [stillness]
bfgilmnu : [fumbling]
acps : [caps]
ademssu : [assumed]
beghiiintx : [exhibiting]
adelpps : [slapped]
addimno : [diamond]
deeelpprx : [perplexed]
ciijnnnotu : [injunction]
ggilnnou : [lounging]
aaglwy : [galway]
acot : [coat, cato]
aehippr : [happier]
accdinortt : [contradict]
bgiint : [biting]
addeeilpss : [displeased]
ggilnnpu : [plunging]
acrz : [czar]
adeehrstt : [shattered]
aadilmort : [maladroit]
efginrs : [fingers]
eemnoos : [someone]
ceinnotu : [continue]
deeersv : [deserve]
acdemopss : [compassed]
delmpru : [rumpled]
adiilnty : [daintily]
eeenorvy : [everyone]
deeprss : [pressed]
aciklmn : [milkcan]
deeertx : [exerted]
aadefghnrrt : [grandfather]
ccesssu : [success]
ghinsttu : [shutting]
cfimnnnooorst : [nonconformist]
ghiinrrw : [whirring]
acdgilns : [scalding]
hiorsty : [history]
iklm : [milk]
dfgilno : [folding]
ikll : [kill]
aenprtt : [pattern]
ikln : [link]
aiillnnortuvy : [involuntarily]
ikls : [silk]
hiirs : [irish]
cdhil : [child]
ceklr : [clerk]
addeimtt : [admitted]
illst : [still]
acdeelpr : [replaced]
ikkn : [kink]
illsy : [silly, slily]
dnossu : [sounds]
beiilsv : [visible]
deegs : [edges]
cdeikk : [kicked]
ceiiinsv : [incisive]
cdeikp : [picked]
adeeeiimnrtt : [intermediate]
iknp : [pink]
ikns : [skin]
aenprrt : [partner]
ggiinv : [giving]
eerttux : [texture]
deegr : [greed]
deefr : [freed]
adefgiirt : [gratified]
deeehlmorvw : [overwhelmed]
acdffhnsu : [handcuffs]
ccehk : [check]
adeeimnrr : [remainder]
aenprst : [parents]
ghnruy : [hungry]
giiilnntvy : [invitingly]
giprss : [sprigs]
effllow : [welloff]
deegnorss : [engrossed]
aceilnnnoss : [nonsensical]
prtuy : [purty]
cefgiiklnr : [flickering]
ceeeenrrv : [reverence]
ceopprst : [prospect]
einorsv : [version]
aadeglmn : [magdalen]
cehrstt : [stretch]
imost : [moist]
giinqttu : [quitting]
ceinnnoostv : [conventions]
amnow : [woman]
ghhosttu : [thoughts]
einoprtu : [eruption]
ceeijor : [rejoice]
aceilnnnott : [continental]
einortu : [routine]
aeeilnpst : [penalties]
cdiilorsuu : [ridiculous]
acdeellr : [recalled]
afhoopstt : [footpaths]
amnor : [roman]
efrtuu : [future]
ellowy : [yellow]
egghiiinnstux : [extinguishing]
eeinssstw : [witnesses]
bceprsttuu : [buttercups]
cdeekpru : [puckered]
abcdeeilnors : [considerable]
ghiinrtw : [writhing]
cdehnpu : [punched]
bdnos : [bonds]
bdnou : [bound]
addeimsy : [dismayed]
ghiillns : [shilling]
demrru : [murder]
abehimno : [bohemian]
ggino : [going]
ikrs : [risk]
ellovy : [lovely]
adeektw : [tweaked]
bceemo : [become]
giiklnn : [inkling]
einoprrs : [prisoner]
ddehnrsu : [hundreds]
addeimrs : [disarmed]
inrsu : [ruins]
cdeeijnt : [injected]
aceprtu : [capture]
abnrw : [brawn]
acchilot : [catholic]
eflorsw : [flowers]
beeklmosu : [smokeblue]
cdeiilosu : [delicious]
cdeiilost : [solicited]
aefrt : [after]
aehnort : [another]
aefrs : [safer, fears]
acdefiilnnot : [confidential]
adggilnn : [dangling]
accdemostu : [accustomed]
aefilru : [failure]
ehinrs : [shrine]
ckluy : [lucky]
adeeknw : [wakened]
aginnrsw : [warnings]
cdeeijor : [rejoiced]
dehilrw : [whirled]
aelstt : [latest]
aeghlnnor : [langhorne]
deeeenstw : [sweetened]
aceennrssuy : [unnecessary]
deoprstu : [proudest]
dnouw : [wound]
eefnqrtu : [frequent]
eggiilnrtt : [glittering]
ceiotx : [exotic]
delosv : [solved]
fgors : [frogs]
ceeginors : [recognise]
ghhottu : [thought]
agghsy : [shaggy]
addeeimnoprt : [predominated]
hkoos : [shook, hooks]
dekloo : [looked]
cdeirs : [dicers]
cdeirt : [direct, credit]
hlmnoty : [monthly]
ceghinnrw : [wrenching]
bcdemnou : [uncombed]
aginoosttt : [tattooings]
eopprsu : [purpose]
cdenoss : [seconds]
eopprst : [stopper]
aeeglry : [eagerly]
aalnrtu : [natural]
behssu : [bushes]
fgoort : [forgot]
aeeinrst : [trainees]
eikntt : [kitten]
dnoru : [round]
adeeeimnrsttv : [advertisement]
aefor : [afore]
ddruy : [ruddy]
bdeehiitx : [exhibited]
ggilnow : [glowing]
ceiopr : [copier]
ceiops : [copies]
cdeeenptux : [unexpected]
ceiopt : [poetic]
egiinrtty : [integrity]
aelsuv : [values]
cdeiop : [copied]
adde : [dead]
biltu : [built]
losuy : [lousy]
ahnooprs : [harpoons]
egiinrttt : [tittering]
deeghiw : [weighed]
ceiosv : [voices]
fssu : [fuss]
ceiilnppr : [principle]
deklsu : [sulked]
aaegimrr : [marriage]
ceffio : [office]
cdeinu : [induce]
aekpss : [speaks]
bhirt : [birth]
dnosu : [sound]
aeehorssuw : [warehouses]
bbginru : [rubbing]
dnosuw : [wounds]
efhrrtu : [further]
ceiilnpprs : [principles]
eillopty : [politely]
epru : [pure]
aeellrrstv : [travellers]
dmoo : [mood, doom]
aeehv : [heave]
acefiostu : [facetious]
efgiorv : [forgive]
beehrw : [hebrew]
aceimnoprt : [importance]
adem : [made]
adeeflntt : [flattened]
adel : [lead, deal]
adeg : [aged]
adef : [deaf]
adei : [idea]
abceflmoort : [comfortable]
adeh : [head]
afhls : [flash]
cekklnsu : [knuckles]
adegiimn : [imagined]
eehnpw : [nephew]
acdehtw : [watched]
dfghioss : [fishgods]
abglrrsu : [burglars]
adew : [wade]
abeehnt : [beneath]
ades : [ades]
ader : [dear, read, dare]
adet : [date]
adhr : [hard]
eptw : [wept]
adhs : [dash]
adhn : [hand]
aiinnortu : [ruination]
cddeeginns : [descending]
elopprry : [properly]
adeeflrt : [faltered]
aahkmotw : [tomahawk]
aeefllrw : [farewell]
gillnor : [rolling]
biknr : [brink]
deeilpr : [replied]
epst : [step]
adgl : [glad]
eilqtuy : [quietly]
ceenoopst : [copestone]
aabcdiillloy : [diabolically]
aanrtt : [tartan]
aberst : [breast]
cflnorsu : [scornful]
aillnqrtuy : [tranquilly]
adgu : [gaud]
aaepprs : [appears]
aaepprt : [parapet]
beeorsstv : [observest]
aciloprt : [tropical]
deeginrs : [resigned]
egimnrry : [merrying]
ciiilmpsty : [simplicity]
ainsst : [stains]
aceeghlorstv : [graveclothes]
acggiint : [gigantic]
eeilrsu : [leisure]
adis : [said]
dmru : [drum]
hrruy : [hurry]
dffgiinsu : [diffusing]
acellr : [cellar, recall]
adip : [paid]
ceitw : [twice]
adim : [maid, amid]
adil : [laid]
einoopssss : [possession]
eglnor : [longer]
acdehpt : [patched]
aeilrwy : [wearily]
abeehrt : [breathe]
adlu : [dual]
acfort : [factor]
abcehllott : [tablecloth]
aceinrt : [certain]
adln : [land]
dddeehrsu : [shuddered]
adlo : [load]
aehhlty : [healthy]
eeginnsv : [evenings]
adefgg : [fagged]
acdehmr : [marched]
cinrstuy : [scrutiny]
eegkrs : [greeks]
adly : [lady]
adglly : [gladly]
efinorrst : [frontiers]
acelns : [lances]
acelnt : [lancet]
adkr : [dark]
adehmorw : [homeward]
aeegr : [agree, eager]
ailmpr : [primal]
adkn : [dank]
eeginnrt : [entering]
acelnu : [unlace]
aabegiilmnnu : [unimaginable]
cehhlooossu : [schoolhouse]
flloy : [folly]
adnw : [dawn]
ainostt : [station]
eenprsst : [presents]
afhsst : [shafts]
diipsttuy : [stupidity]
fgillnoow : [following]
agiilpt : [pigtail]
eemopssttuu : [tempestuous]
deeenprst : [presented]
fmors : [forms]
aiilnqrttuy : [tranquility]
eglnty : [gently]
aegghinrt : [gathering]
dginy : [dingy, dying]
eenprstv : [prevents]
deelorsv : [resolved]
ceefilnnu : [influence]
celnoos : [console]
admn : [damn]
ceipr : [price]
ccdgilnnou : [concluding]
admp : [damp]
ceefllprstuy : [respectfully]
aepprs : [papers]
deeenprtv : [prevented]
dgino : [doing]
beeemmrrs : [remembers]
ghinrruy : [hurrying]
aeoprrstt : [prostrate]
giinpprt : [tripping]
aeilrty : [reality]
agilnrstt : [startling]
aceinnt : [ancient]
fgghiint : [fighting]
cddeinu : [induced]
eirtuv : [virtue]
agiilns : [sailing]
aefgilnrt : [faltering]
agiilnw : [wailing]
ceeilpss : [eclipses]
adoorswy : [doorways]
beefinst : [benefits]
bceegir : [iceberg]
aefiilms : [families]
ghilnruy : [hungrily]
emmnot : [moment]
ddeiimsss : [dismissed]
bgru : [grub]
ainosux : [anxious]
ceirs : [cries]
ados : [soda]
afillny : [finally]
ador : [road]
aefsty : [safety]
ceinnnot : [innocent]
ghortuw : [wrought]
defnoortu : [underfoot]
cdfnnoou : [confound]
aehhistww : [whitewash]
adrw : [draw, ward]
adry : [yard]
adrt : [dart]
adrs : [ards]
ceimn : [mince]
ablsw : [bawls]
ekops : [spoke]
acegiinnrs : [increasing]
ceimr : [crime]
elrsu : [rules]
acdinors : [sardonic]
efggior : [foggier]
cceinost : [conceits]
achimos : [chamois]
ceesux : [excuse]
cenooqrru : [conqueror]
aaegsv : [savage]
bceeeelnnov : [benevolence]
ceils : [slice]
eehiorstw : [otherwise]
ceilv : [clive]
acdeeimmnnoort : [recommendation]
aacelps : [palaces]
ceiov : [voice]
cdeeginpr : [preceding]
aadglnr : [garland]
illt : [till]
ills : [sill]
illw : [will]
adsy : [days]
ccddenotu : [conducted]
fgiilnrt : [trifling, flirting]
elrru : [ruler]
enrrstu : [returns]
ceins : [since]
aacderttt : [attracted]
abcdelmrs : [scrambled]
ejlly : [jelly]
cdeillot : [clotilde]
aegnrrst : [stranger]
anpsy : [pansy]
emmmru : [mummer]
aellquy : [equally]
gimnnors : [mornings]
acgiinnnot : [containing]
gimnnoru : [mourning]
aajnv : [javan]
ilnt : [lint]
deehmorst : [smothered]
egiilnv : [veiling]
accept : [accept]
bdelmstu : [stumbled]
adeenr : [earned]
ilmp : [limp]
ilms : [slim]
aabbhst : [sabbath]
accesu : [accuse]
adeeinrstt : [straitened]
aaistw : [awaits]
cddeeu : [deduce, deuced]
ginvy : [vying]
ilps : [lips]
aeehhhinst : [heathenish]
cddeei : [decide]
aceeennstv : [evanescent]
deimnoot : [motioned]
fiottu : [outfit]
effrsu : [suffer]
ceelrtu : [lecture]
hill : [hill]
aeiillnqrstu : [tranquillise]
acceelmnnot : [concealment]
belmtu : [tumble]
ffghilrtu : [frightful]
hknsu : [hunks]
beeeilv : [believe]
prssu : [spurs]
ginty : [tying]
fimnor : [inform]
aceeefrr : [carefree]
abcdeemr : [embraced]
adeest : [seated]
adeeltx : [exalted]
agiinnpt : [painting]
dekmos : [smoked]
eeeilnpsss : [sleepiness]
ceeennst : [sentence]
cegoors : [scrooge]
eeeimnrrtt : [retirement]
abccoot : [tobacco]
beehrty : [thereby]
ccinnoorsttu : [construction]
bceeloorrttu : [buttercooler]
acdeegklnosw : [acknowledges]
aeiirrst : [rarities]
adeerr : [dearer, reader]
cdeiilostu : [solicitude]
hint : [thin, hint]
deffnsu : [snuffed]
belmru : [rumble]
cghosu : [coughs]
aaccfiiilrs : [sacrificial]
opsst : [spots]
aeevw : [weave]
acenpttuu : [punctuate]
acprs : [scrap]
aajlp : [jalap]
aostt : [toast]
ginrs : [rings]
nnsuy : [sunny]
imnor : [minor]
bdeeorsv : [observed]
ggghinrsu : [shrugging]
cdehmnu : [munched]
aabborrsu : [barbarous]
acderstt : [detracts]
lmopprty : [promptly]
ceinoprst : [inspector]
ginsw : [swing, wings]
ceinoprsv : [provinces]
aaegmn : [manage]
ginss : [signs, sings]
ginst : [sting]
ginsu : [using]
cegiinnoort : [recognition]
hips : [ship]
ilst : [slit]
agiinnst : [staining]
aafiilmr : [familiar]
eggorr : [gregor]
eensv : [seven]
bdgiilnu : [building]
eenss : [sense]
hist : [this]
chiklmost : [locksmith]
adeelps : [pleased, elapsed]
hisw : [wish]
adeegr : [agreed]
aacfinstt : [fantastic]
ddeiopss : [disposed]
cehkoy : [hockey]
aaahknrst : [astrakhan]
aeginpsty : [egyptians]
eilopstuy : [piteously]
aegilnnr : [learning]
eenrv : [never]
eenrw : [renew]
deilnsw : [swindle]
accehn : [chance]
eenrt : [enter]
ddeioprv : [provided]
abdeehilsst : [established]
eoppssu : [suppose]
adeefr : [feared]
cdeiilpss : [disciples]
aeers : [erase]
abdeost : [boasted]
aaillmnoprtt : [allimportant]
beegilmnrs : [resembling]
deilnps : [spindle]
ghiilmty : [mightily]
adeelrx : [relaxed]
adeelrt : [related, altered]
adeelrs : [leaders]
behrst : [berths]
aeirtvy : [variety]
eilrsv : [silver]
acekpt : [packet]
aeest : [tease]
adeehv : [heaved]
eentv : [event]
ceiosty : [society]
hitw : [with, whit]
deeefprrr : [preferred]
adgilnr : [darling]
adeeht : [heated]
adgilnn : [landing]
acdgghiinrs : [discharging]
adeehp : [heaped]
aeghimnrt : [nightmare]
ceegimnnoprs : [recompensing]
cdeeijprsu : [prejudices]
kloos : [looks]
ghhotu : [though]
deginnorsu : [resounding]
cdehko : [choked]
bcdeeiprrssu : [superscribed]
aeelv : [leave]
hiwz : [whiz]
eelrrvy : [revelry]
adddeerss : [addressed]
egiinrstu : [intrigues]
ceinot : [notice]
ckkno : [knock]
adegrrs : [regards]
ccdehklu : [chuckled]
adeelmr : [emerald]
giilnv : [living]
eginnrrtu : [returning]
eeehnrvw : [whenever]
acdeeilmx : [exclaimed]
giilnp : [piling]
ghiprtu : [upright]
aegnrsstt : [strangest]
aeent : [eaten]
hinoorz : [horizon]
cklo : [lock]
aaccdelltu : [calculated]
eenqu : [queen]
aachilpst : [asphaltic]
adeelnr : [learned]
abbhsy : [shabby]
aghmnoopr : [monograph]
aefs : [safe]
aefr : [fear, fare]
dnow : [down]
dnou : [undo]
aeft : [fate]
iinooopprst : [proposition]
aderrsw : [drawers]
ddeelopr : [deplored]
aehhlt : [health]
cdiillorsuuy : [ridiculously]
gimnnor : [morning]
cghiilln : [chilling]
adeelp : [leaped]
adegrty : [tragedy]
adeeln : [leaned]
ceinpr : [prince]
acpprsy : [scrappy]
adeelr : [leader]
aees : [ease]
aehp : [heap]
aehr : [hear, hare]
eelorsv : [resolve]
chittw : [twitch]
bdeehl : [beheld]
adeks : [asked]
eeghnnrstt : [strengthen]
einquu : [unique]
accdeint : [accident]
adegiknnrtu : [undertaking]
deefiirrt : [terrified]
aeht : [heat]
acdeemn : [menaced]
aehv : [have]
aegp : [page]
adeln : [laden]
aegr : [rage]
gghiins : [sighing]
aeemnptv : [pavement]
aegm : [game]
adelr : [adler]
beeirrtt : [bitterer]
aegw : [wage]
aegz : [gaze]
moors : [rooms]
aegt : [gate]
aegs : [ages]
aegv : [gave]
aehps : [shape]
adeillmrt : [treadmill]
ademr : [dream]
ademn : [named, amend]
accdeily : [delicacy]
gimnotu : [ignotum]
deflnoruw : [wonderful]
adekmr : [marked]
adekms : [masked]
adefilmn : [inflamed]
adeklw : [walked]
aceltxy : [exactly]
bghinrsu : [brushing]
ckor : [rock]
ckoo : [cook]
eeqru : [queer]
eelorstu : [resolute]
acdeelr : [cleared]
diknrs : [drinks]
aelt : [late, tale]
aelv : [vale]
aelp : [pale, peal]
bhot : [both]
aels : [sale]
afltuy : [faulty]
aelr : [real]
adegr : [raged]
aelm : [male, meal]
aeln : [lane, lean]
agnps : [pangs]
emnoorsu : [enormous]
ceilnps : [pencils]
ailrwy : [warily]
adegz : [gazed]
aaginorstv : [navigators]
ddeeinst : [destined]
adeeiimmt : [immediate]
aelz : [zeal]
aekt : [take]
aeks : [sake]
adehl : [haled]
adelnst : [slanted]
aekl : [leak, lake]
adehs : [heads, shade]
adehr : [heard]
eghhist : [highest]
aehks : [shake]
aegiinprr : [repairing]
cenrrtu : [current]
adeht : [death]
aekm : [make]
afknr : [frank]
ghilnstu : [sunlight]
bghit : [bight]
aekw : [wake, weak]
aenr : [near, earn]
dnorrsuu : [surround]
aent : [neat]
agnry : [angry]
aehlw : [whale]
adeis : [ideas, aside]
aaadegntv : [advantage]
agnrt : [grant]
acdeilttuv : [cultivated]
eelssv : [vessel]
egiilnnst : [listening]
eimntu : [minute]
aelstty : [stately]
gnouy : [young]
deeilnst : [listened]
adekqu : [quaked]
cehiknt : [kitchen]
cksu : [suck]
aemt : [meat]
aems : [same]
dgiimnoss : [sigismond]
aemn : [name, mean]
ehitw : [white]
agnsw : [swang]
einprrttu : [interrupt]
aehnpp : [happen]
aehms : [shame]
acckrs : [cracks]
aacmnst : [sanctam]
acdeehr : [reached]
eefnrtv : [fervent]
aeilnort : [relation, oriental]
eeginnu : [genuine]
achiimnoprst : [misanthropic]
eelstt : [settle]
eeginnv : [evening]
fghiinst : [shifting]
aept : [pate]
ddeeoprw : [powdered]
eiltt : [title]
adelnpt : [planted]
deginnopr : [pondering]
achirs : [chairs]
aadeilss : [assailed]
agiikllnnoop : [plainlooking]
flouw : [woful]
ehirt : [their]
afginry : [fraying]
acdlnost : [scotland]
inoopprttuy : [opportunity]
deeoopprtv : [overtopped]
ddeeinnt : [intended]
aabdorrst : [starboard]
aacdeilpttu : [capitulated]
cnorsw : [crowns]
ghiinns : [shining]
aabdeemrrss : [embarrassed]
abddeeht : [deathbed]
aerw : [wear]
bdelmmu : [mumbled]
aery : [year]
aers : [ears]
aerr : [rare, rear]
aert : [tear]
aenoss : [season]
eilrv : [liver]
deginoruv : [devouring]
abceeiillnpx : [inexplicable]
aghhoopprt : [photograph]
deginnorw : [wondering]
aehht : [heath]
deelmopy : [employed]
dfgiinn : [finding]
aeeiinnoprrttt : [interpretation]
eilss : [isles]
eilsv : [lives, evils]
agnor : [groan]
afkln : [flank]
accceimnrstu : [circumstance]
eenoprss : [response]
gnorw : [grown, wrong]
agnoy : [agony]
accdeinst : [accidents]
ddehnru : [hundred]
bdeelt : [belted]
eilpr : [peril]
eilps : [spile]
ginopprsu : [purposing]
adeehistt : [hesitated]
gnoor : [ognor]
ccceeinnos : [conscience]
abbelopr : [probable]
dfins : [finds]
aagillnpp : [appalling]
fklos : [folks]
bcginorsu : [obscuring]
aesy : [easy]
agilnprsw : [sprawling]
aest : [eats, seat]
aess : [seas]
aesv : [save]
aellmorsuv : [marvellous]
aagiknw : [awaking]
cdenorstu : [construed]
ceeeegimnrs : [emergencies]
aabdeehrrt : [threadbare]
bcektu : [bucket]
gorss : [gross]
eeprssx : [express]
cdeekkknno : [knockkneed]
deenrrtu : [returned]
adelnnp : [planned]
ceiknsss : [sickness]
aeefnrsst : [fasteners]
eilnn : [linen]
adgiimnrs : [disarming]
eprtty : [pretty]
eilns : [lines]
dehmot : [method]
aabcdeln : [balanced]
acdnnu : [duncan]
floor : [floor]
floos : [fools]
aceemorv : [overcame]
ciiopsssuu : [suspicious]
ainnstt : [instant]
eflmsy : [myself]
bdeeis : [beside]
bdeeil : [belied]
ehilt : [lithe]
aghinorrw : [harrowing]
ehilw : [while]
ghiinss : [hissing]
acehlmoorsst : [schoolmaster]
degiu : [guide]
defgor : [forged]
ceehims : [chemise]
acceiimmnotuv : [communicative]
belmrstu : [tumblers]
deeopssss : [possessed]
imps : [imps]
eelnprsty : [presently]
bcmru : [crumb]
abefhl : [behalf]
ghiintt : [hitting]
degir : [ridge]
aeprssst : [trespass]
eeiinsstv : [sensitive]
abddeest : [bedstead]
bdelmtu : [tumbled]
aailprssy : [paralysis]
aehlssss : [sashless]
cddeinotu : [deduction]
ekloor : [looker]
acilos : [social]
aaeklop : [oakpale]
abeeflln : [befallen]
aaelrt : [altare]
ginoppssu : [supposing]
ailorss : [sailors]
giloorsu : [glorious]
cdeefnoss : [confessed]
degippr : [gripped]
aeimmnopt : [pantomime]
ekloost : [lookest]
abhilmntu : [thumbnail]
deeepst : [deepest]
degju : [judge]
abeehrst : [breathes]
deeppst : [stepped]
aeiimntt : [intimate]
acinrtu : [curtain]
ceehins : [chinese]
eirstuv : [virtues]
hjno : [john]
aaeellnrtty : [alternately]
acdiiinnot : [indication]
ansuy : [unsay]
achins : [chains]
aacdelnr : [calendar]
aiiimnooprsstv : [improvisations]
eghiinrsv : [shivering]
addeginnnrstu : [understanding]
abddeenr : [bedarned]
almor : [moral]
bdelmoo : [bloomed]
aemrsstt : [smartest, mattress]
ilntu : [until]
eillnsty : [silently]
cgilnnnuy : [cunningly]
ehinors : [inshore]
afginnn : [fanning]
almpy : [amply]
ghimty : [mighty]
almps : [lamps, palms]
ampst : [stamp]
aenors : [reason]
adhirtww : [withdraw]
imst : [mist]
imss : [miss]
adeginprsu : [persuading]
imsw : [swim]
aabcmn : [cabman]
cdeepsstu : [suspected]
dginoopr : [drooping]
crstu : [crust]
cemos : [comes]
cfginnnoort : [confronting]
accinooss : [occasions]
deelnoprux : [unexplored]
ciimtv : [victim]
aenopw : [weapon]
bilmny : [nimbly]
aamss : [samsa]
ccehiost : [choicest]
cdeors : [scored]
aacfinr : [african]
eegiilprv : [privilege]
bdeeostw : [bestowed]
gijmnpu : [jumping]
eimnstu : [minutes]
adesv : [saved]
aehvy : [heavy]
airsst : [stairs]
adesy : [deasy]
denoow : [wooden]
deorrs : [orders]
ddeeerst : [deserted]
effginrsu : [suffering]
eiinrsst : [sinister]
ddenosu : [sounded]
ceeitx : [excite]
eeginpr : [peering]
eeginpp : [peeping]
aceeeilmnpt : [mantelpiece]
airstt : [artist]
cddeeipt : [depicted]
hprrsuy : [pyrrhus]
efgginortt : [forgetting]
ilnos : [lions]
eeginpw : [weeping]
hiknt : [think]
bberru : [rubber]
adfhlnu : [handful]
aceeglrss : [graceless]
bdehrsu : [brushed]
aeefmnorrsy : [freemasonry]
adeeimnoprst : [predominates]
acegimnrs : [screaming]
bdeflmu : [fumbled]
addehlmpssu : [mudsplashed]
aceerrsty : [secretary]
eginor : [region]
aceerrstu : [creatures]
acggilnn : [glancing]
anstw : [wants]
adevw : [waved]
giiknns : [sinking]
cdeenostt : [contested]
adeflot : [floated]
aeeilrrttu : [literature]
eeeennstv : [seventeen]
elnoss : [lesson]
aabeiilnrv : [invariable]
acegginnoru : [encouraging]
giiknnw : [winking]
eeginrv : [veering]
eiorssu : [serious]
cefghint : [fetching]
eiorsst : [stories]
ddenoru : [rounded]
aehrt : [earth, heart]
door : [door, odor]
aehrs : [share, hears]
aeinoorrstt : [restoration]
adeefinrr : [refrained]
aceeillnrsuv : [surveillance]
eimnno : [nomine]
doow : [wood]
biis : [ibis]
aceinoprtu : [precaution]
eeelssv : [sleeves]
denorw : [wonder]
aehsv : [shave]
aehss : [ashes]
eeilnnsst : [sentinels]
aehst : [haste, hates]
deefginnu : [unfeigned]
aeikmsst : [mistakes]
ceeipr : [pierce]
acceiprt : [practice]
ceeips : [pieces]
elpuzz : [puzzle]
einoqsstu : [questions]
adepv : [paved]
abeirrz : [bizarre]
denory : [yonder]
eeeiprssvx : [expressive]
ailmmort : [immortal]
gilnnuzz : [nuzzling]
ertu : [true]
afhl : [half]
aacdefinst : [fascinated]
inopst : [points]
ceeilns : [silence]
fgilnow : [flowing]
aginostt : [toasting]
gimnopp : [mopping]
prsu : [spur]
fgilnoo : [fooling]
oopr : [poor]
ahopst : [pathos]
erty : [tyre]
addeopt : [adopted]
eginsu : [genius]
ersu : [sure]
adert : [tread, trade]
erst : [rest]
dopr : [drop, prod]
beemnorv : [november]
aders : [reads]
aacfir : [africa]
adery : [ready]
deorst : [sorted, strode]
abcehmrs : [chambers]
deorsu : [roused]
eefnortu : [fourteen]
aginnpps : [snapping]
acdeepr : [capered]
acdeeps : [escaped]
aadilwy : [waylaid]
behilorr : [horrible]
eginrs : [singer]
aadeeppr : [appeared]
bceemos : [becomes]
aeglm : [gleam]
abdelst : [blasted]
aegln : [angel, angle]
aegll : [legal]
aeikmst : [mistake]
addiv : [david]
aegls : [gales]
cdostuy : [custody]
aeglr : [large, glare]
oort : [root]
abbost : [abbots]
aeirrv : [arrive]
acdorw : [coward]
eimotv : [motive]
ervy : [very]
dort : [trod]
afir : [fair]
afil : [fail]
cloo : [cool]
afin : [fain]
abhorru : [harbour]
bill : [bill]
aceilst : [elastic]
defioprt : [profited]
aelssst : [tassels]
aceeimnqrtu : [acquirement]
celmoy : [comely]
dorw : [word]
aflt : [flat]
aegnr : [anger]
deelstt : [settled]
beggilnno : [belonging]
aceilrt : [recital]
aflo : [loaf]
dgikmno : [kingdom]
efghiilrt : [firelight]
afll : [fall]
aaegpss : [passage]
diimnnoo : [dominion]
aegnt : [agent]
bimrs : [brims]
deewy : [weedy]
adeenoruv : [endeavour]
acdenosvy : [sandycove]
bdeeiss : [besides]
bdgiinn : [binding]
ceeeimnn : [eminence]
bddeirstu : [disturbed]
glnsuy : [snugly]
iiprsstu : [spiritus]
addeeknr : [darkened]
aginnort : [ignorant]
deevx : [vexed]
adelnp : [planed]
elmosuv : [volumes]
eghinorv : [hovering]
acdeeklns : [slackened]
bnnottuu : [unbutton]
bchlooossy : [schoolboys]
aistw : [waits, waist]
addef : [faded]
aadhilly : [halliday]
acehimn : [machine]
adder : [dared]
aefimn : [famine]
aeeggnos : [gasogene]
agmno : [among]
addet : [dated]
cdeenovy : [conveyed]
egilntt : [letting]
aegim : [image]
adelpy : [played]
afmr : [farm]
bdeeimt : [bedtime]
ahprs : [sharp]
forsty : [frosty]
adiloorstu : [idolatrous]
aeilnnrt : [internal]
aeqrssu : [squares]
adeeegrw : [edgeware]
eillvy : [lively]
eegginrst : [greetings]
aclmoru : [clamour]
aaginoopprt : [propagation]
aceeilllnttu : [intellectual]
aeglns : [angels]
ahpst : [paths]
ddeeehillsv : [dishevelled]
fgiinr : [firing]
acdefin : [fancied]
deess : [seeds]
deemnnostw : [endowments]
acdhorr : [orchard]
deesw : [weeds, sewed]
adelst : [salted, lasted]
afilmy : [family]
aceilmt : [climate]
dhiorr : [horrid]
birs : [ribs]
aceilmr : [miracle]
adelry : [dearly]
aaccddemmoot : [accommodated]
aehors : [hoarse]
ahmnoss : [hansoms]
eeltvw : [twelve]
bdeeglno : [belonged]
eeltvv : [velvet]
eilltt : [little]
achiinrst : [christian]
aceilmx : [exclaim]
aaeeehkprss : [shakespeare]
aelopsst : [apostles]
afrt : [raft]
abbdegl : [gabbled]
giilnppr : [rippling]
deefiiilnnty : [indefinitely]
giilnpps : [slipping]
agiintw : [waiting]
aeeirrst : [arteries]
adeklnp : [planked]
aeehnooprrs : [harpooneers]
ddgiilnr : [riddling]
cddeeinorsuv : [undiscovered]
ceiopprs : [croppies]
cekknor : [knocker]
beeegimmnrr : [remembering]
acenorsst : [ancestors]
adforrw : [forward]
ffgino : [offing]
aegiimnnx : [examining]
hrttu : [truth]
aegiimnnr : [remaining]
eefmoprrr : [performer]
cdhtu : [dutch]
ceeilnot : [election]
agiinrs : [raising]
ceeilnov : [violence]
eillwy : [wyllie]
aacciopsu : [capacious]
aeimssv : [massive]
deillottvy : [dottyville]
aacenpsu : [saucepan]
addde : [added]
accelno : [conceal]
afst : [fast]
abdhknoo : [handbook]
deiistv : [visited]
ahppy : [happy]
deens : [dense, needs]
bbhoy : [hobby]
aemnnrs : [manners]
aalrsy : [salary]
beeellnnotvy : [benevolently]
ghhi : [high]
dehlorssu : [shoulders]
defiijstu : [justified]
filstwy : [swiftly]
deeir : [eider]
delnooprsuy : [ponderously]
deehw : [hewed]
aceeinopttx : [expectation]
aeiilnnottv : [ventilation]
degnooss : [goodness]
adeemort : [moderate]
bimnsu : [nimbus]
aehmostw : [somewhat]
adelopr : [leopard]
cdeginnnot : [contending]
abcehkors : [horseback]
ddgiilmn : [middling]
ciksst : [sticks]
ademrsw : [swarmed]
chistw : [switch]
ejnos : [jones]
eikls : [likes]
aikmnnosw : [kinswoman]
elrttuy : [utterly]
ejnoy : [enjoy]
abekorrstw : [breastwork]
aabddenno : [abandoned]
bcejot : [object]
inpt : [pint]
acerst : [crates]
acfhltuw : [watchful]
cekrw : [wreck]
deeegr : [degree]
ghin : [nigh]
adeenrsw : [answered]
belstu : [subtle]
abbors : [absorb]
ddefirt : [drifted]
inor : [iron]
ghis : [sigh]
inot : [into]
beilopss : [possible]
effiort : [forfeit]
ceehks : [cheeks]
eeeglmnnt : [gentlemen]
aehlstty : [stealthy]
aalrt : [altar]
celos : [close]
hkoo : [hook]
celov : [clove]
lmosty : [mostly]
adefmnorrst : [transformed]
adginnst : [standing]
inru : [ruin]
abemnsu : [sunbeam]
ceeilmrss : [merciless]
lorsstuu : [lustrous]
oorst : [roots]
deeems : [seemed]
bcklos : [blocks]
aelmrsv : [marvels]
acimno : [monica]
eilms : [smile, miles]
celnu : [uncle]
acryz : [crazy]
deefrsu : [refused]
boost : [boots]
bdotu : [doubt]
adeerrssu : [reassured]
efgiinprst : [fingertips]
deeeln : [needle]
dfilu : [fluid]
bdnooy : [nobody]
defix : [fixed]
aeehorsuw : [warehouse]
ciortvy : [victory]
allsw : [walls]
abekortu : [outbreak]
belsstu : [bustles]
allsy : [sally]
acegiinnntu : [enunciating]
egnrstu : [gunrest]
aggikllnooss : [lookingglass]
deefrtt : [fretted]
ghnu : [hung]
defil : [field]
eeillostv : [loveliest]
defin : [fined]
adeerrstv : [traversed]
defir : [fried]
dirty : [dirty]
beeghprrstu : [petersburgh]
defflmu : [muffled]
aacilrty : [alacrity]
bcmrsu : [crumbs]
aabdll : [ballad]
aaellnprrstuuy : [supernaturally]
abiiilmntuu : [iubilantium]
ceilmoootv : [locomotive]
eefginrrr : [referring]
bclsu : [clubs]
cdehotu : [touched]
bdoor : [brood]
cdefino : [confide]
ccehikkossty : [hockeysticks]
eeefhorrw : [wherefore]
eeefhorrt : [therefore]
ghilst : [lights, slight]
cdenos : [second]
allms : [small]
aalnv : [naval]
bbehlos : [hobbles]
elnpty : [plenty]
adginnor : [adorning]
defgory : [godfrey]
aceilmrru : [mercurial]
bddeeint : [indebted]
cdenno : [conned]
eefrrs : [refers]
aafhlwy : [halfway]
aacdeinnqtuu : [unacquainted]
allow : [allow]
deeepr : [peered, deeper]
cefkls : [flecks]
oortt : [rotto]
deeepp : [peeped]
ceehilln : [hellenic]
acehmnrt : [merchant]
abost : [boast]
aabdor : [abroad, aboard]
aceimnops : [companies]
aenprt : [parent]
diiinoopsst : [disposition]
acilprrstu : [scriptural]
abhilnrty : [labyrinth]
aaceeipprt : [appreciate]
abotu : [about]
aabceln : [balance]
beehillms : [embellish]
cdeefht : [fetched]
aabcelp : [capable]
acinrstu : [curtains]
ghhily : [highly]
fgillors : [figrolls]
bcdeeiilnrsttu : [indestructible]
ahmnory : [harmony]
deinrtu : [intrude]
aaelnvz : [lavenza]
ddeoprrtu : [protruded]
aegnrst : [strange, sargent]
aeguv : [vague]
ceehrw : [chewer]
eghilrt : [lighter]
deosst : [tossed]
cddeehnr : [drenched]
ghsu : [gush]
ehkooy : [hookey]
eehlrst : [shelter]
bghortu : [brought]
adgilnpsu : [spaulding]
ehnorstu : [southern]
ahmnopt : [phantom]
abblopry : [probably]
ahimnprttu : [triumphant]
aehnsv : [shaven]
adellosww : [swallowed]
acrry : [carry]
cceemmno : [commence]
ghinnot : [nothing]
eghlnt : [length]
himprtu : [triumph]
aeeilnsst : [essential]
accehnor : [cochrane]
aghinssv : [shavings]
gipsy : [gipsy]
efgort : [forget]
defnnoss : [fondness]
eefiimnn : [feminine]
aalmr : [alarm]
hlssu : [slush]
ceenoprrsstw : [corpsestrewn]
aegps : [pages]
aghn : [hang]
aceeeinsstt : [necessitate]
ceehos : [echoes]
abeehilmnssstt : [establishments]
aaeioppprrt : [appropriate]
aacdektt : [attacked]
eepsw : [sweep]
aghilmty : [almighty]
aaenrrstt : [arrantest]
ciiorstuy : [curiosity]
oppr : [prop]
deiiklnnss : [kindliness]
eiimnoprss : [impression, permission]
eillmr : [miller]
abegmor : [embargo]
aghs : [shag, gash]
eimorsstuy : [mysterious]
estw : [west]
esst : [sets]
acemopsss : [compasses]
ceehnw : [whence]
aacdeemnntv : [advancement]
ceehnt : [thence]
cceknoy : [cockney]
amoprsxy : [paroxysm]
eeprt : [peter]
aginorst : [roasting]
eghilns : [english]
abcehnrs : [branches]
aginnopt : [poignant]
demmnosu : [summoned]
cceemmor : [commerce]
essw : [sews]
einrtw : [winter]
essu : [uses]
eginppst : [stepping]
aegrv : [grave]
aegrt : [great]
eqstu : [quest]
adelnsstu : [dauntless]
akmnorw : [workman]
opru : [pour]
aeehlrt : [leather]
adeiimnott : [meditation]
cdeenpru : [prudence]
adeefllorst : [forestalled]
aegsw : [wages]
aegst : [stage]
abeinoorstv : [observation]
ceehps : [speech]
agin : [gain]
eeeehrrvwy : [everywhere]
eppru : [upper]
aefhrt : [father]
eelorssuv : [ourselves]
gnrstu : [strung]
agit : [gait]
ghinntu : [hunting]
effoprt : [trepoff]
aadeinorrrtxy : [extraordinary]
eoprs : [prose]
eegrsstu : [gestures]
eoprw : [power]
eoprv : [prove]
abdrsu : [absurd]
aaeghnoprty : [pythagorean]
cdeegiiln : [diligence]
belmstu : [stumble]
cdeeerst : [secreted]
accinnoortt : [contraction]
aeilotv : [violate]
agly : [algy]
acllnorw : [cornwall]
dehlorsu : [shoulder]
eopst : [poets]
aacchmno : [coachman]
acdeelrtt : [clattered]
eestw : [sweet]
eeffginorr : [forefinger]
aagimnz : [amazing]
cdeinostttu : [constituted]
eeehrrvw : [wherever]
bcgoru : [coburg]
aceefilprs : [fireplaces]
addeenrw : [wandered]
aabeklmrry : [remarkably]
opst : [tops, post, stop, spot]
agmnorrst : [armstrong]
bhmtu : [thumb]
agns : [sang]
agnr : [rang]
epsst : [steps]
deeilpsy : [speedily]
cddeeehmnopr : [comprehended]
aehimnnosstt : [astonishment]
epstw : [swept]
addeentt : [attended]
deooprt : [trooped]
epstu : [upset]
aehilvy : [heavily]
aacddeint : [candidate]
dghilno : [holding]
cehimny : [chimney]
acdginn : [dancing]
cegijnoprt : [projecting]
abegilr : [gabriel]
cdeeilmmnopt : [complimented]
adeirsst : [disaster]
dinosww : [windows]
aeelntuv : [eventual]
aeefrstu : [features]
opxy : [poxy]
aaclltuy : [actually]
aejny : [janey]
abegilnopprtt : [blottingpaper]
ddeenopr : [pondered]
aceors : [coarse]
aeinnossst : [sensations]
acceino : [cocaine]
adellow : [allowed]
cdehilnr : [children]
aacceikoopstttw : [waistcoatpocket]
aeegnnrssst : [strangeness]
acdffir : [cardiff]
aelnnoops : [napoleons]
abegint : [beating]
abeginr : [bearing]
agry : [gray]
cceeemmmnnot : [commencement]
adgmo : [dogma]
jostu : [joust]
agloopy : [apology]
abdeeeilrt : [deliberate]
ddeeeinnnpt : [independent]
achhiilloopps : [philosophical]
adeglmos : [gladsome]
eeimrssty : [mysteries]
ddeeilmw : [mildewed]
abiilnorsttu : [tribulations]
ddeenorw : [wondered]
eehlssv : [shelves]
adgnr : [grand]
dddeiiv : [divided]
aghiinnsv : [vanishing]
istxy : [sixty]
aehllt : [lethal]
eiloprsuvy : [previously]
eeghortt : [together]
adeilt : [detail]
efiiilmpss : [simplifies]
adeiln : [nailed]
eflorw : [flower]
deglno : [golden]
defikn : [knifed]
abceeiilnrtx : [inextricable]
deirtv : [divert]
deglnu : [lunged]
ahsst : [stash]
aeoptt : [teapot]
aeqrrtu : [quarter]
enoprss : [persons]
beiiilnsv : [invisible]
fghinortt : [fortnight]
aagnnstt : [stagnant]
afgilno : [loafing]
deenrtuv : [ventured]
acdef : [faced]
aadggimn : [damaging]
deirsv : [drives, divers]
acdep : [paced]
acder : [cared]
agst : [tags]
cdeiorrst : [directors]
dehopp : [hopped]
afgilnr : [flaring]
ahsty : [hasty]
beeorsv : [observe]
dnnootww : [downtown]
acchrst : [scratch]
bdeeeglo : [obleeged]
egorrs : [rogers]
cdeiloss : [disclose]
ceeeeinprx : [experience]
assty : [stays]
deirrv : [driver]
cdeimmott : [committed]
agprs : [grasp]
deirrs : [riders]
aeensssttu : [astuteness]
aceeiimnpt : [impatience]
enooprsttu : [portentous]
deinrsttu : [intrusted]
aceeinopsttx : [expectations]
ceefhllruy : [cheerfully]
cdeehpr : [perched]
eehlmoss : [homeless]
isttw : [twist]
aaeilmnnott : [lamentation]
acddeeht : [detached]
dehrrtu : [druther]
cikrst : [tricks]
deoopst : [stooped]
dgisstu : [disgust]
abeghiioprs : [biographies]
eintu : [unite]
efklsu : [flukes]
deeklooorv : [overlooked]
cgiimmnooprs : [compromising]
aenrstv : [servant]
abceghiln : [bleaching]
dehop : [hoped]
deprsuu : [pursued]
dehor : [horde]
hlmt : [html]
egnotu : [tongue]
clnostu : [consult]
filssuy : [fussily]
aeeiorrsttv : [restorative]
bginorruw : [burrowing]
aabcdkrsw : [backwards]
aehimmooprsst : [metamorphosis]
ggiilnnt : [tingling]
definr : [friend]
ceepstx : [expects]
eflouw : [woeful]
aelmpss : [samples]
eeeinpsvx : [expensive]
dehhloosu : [household]
beikoos : [bookies]
eehirt : [either]
eegilnrtw : [weltering]
acddeees : [deceased]
ccdeinoot : [decoction]
dehosw : [showed]
aeiilmpr : [imperial]
deeggsstu : [suggested]
einrs : [risen]
cghinotu : [touching]
dehosu : [housed]
dehosv : [shoved]
abiilllnrty : [brilliantly]
floors : [floors]
gilm : [glim]
gilr : [girl]
gilt : [gilt]
hloy : [holy]
aaddehln : [headland]
defill : [filled]
aeginnry : [yearning]
defils : [fields]
aadhilrstww : [withdrawals]
cdejnoru : [conjured]
abfiilllny : [infallibly]
einsv : [vines]
ghiiknnt : [thinking]
deglos : [lodges]
defilt : [lifted]
aellmrs : [smaller]
gikn : [king]
aenrssw : [rawness]
ddemo : [domed]
aabciln : [caliban]
giinrstv : [striving]
cdeiklrt : [trickled]
aceelnrw : [lawrence]
deimx : [mixed]
aempttt : [attempt]
aadeeeprstx : [exasperated]
ehlos : [holes]
addert : [darted, traded]
ehlow : [whole]
ahirstt : [athirst]
achkmmo : [hammock]
elmnos : [solemn]
eggiilnnst : [glistening]
ceeiinoprsttv : [introspective]
ginr : [ring, grin]
gins : [sign, sing]
adeenors : [reasoned]
aackorwy : [rockaway]
aaaghpprrs : [paragraphs]
aadinrt : [radiant]
adderw : [edward]
deilv : [lived, devil]
deilw : [wilde]
adhoswy : [shadowy]
deily : [yield]
cdeeiln : [decline]
deglnoopr : [prolonged]
acdeerstt : [scattered]
ceotv : [covet]
cghinouv : [vouching]
gmoor : [groom]
efnortu : [fortune]
gimr : [grim]
ceelnrty : [recently]
deiln : [lined]
deilp : [piled]
deilr : [idler]
dflos : [folds]
deils : [slide]
aeghrt : [gather]
cdeeijpru : [prejudice]
ffmu : [muff]
ceelmopt : [complete]
abceflmnoortu : [uncomfortable]
cddeorw : [crowded]
eemoorrv : [moreover]
ehhiortt : [hitherto]
hlsu : [lush]
egimm : [gimme]
bdettu : [butted]
eflmorry : [formerly]
ehilmrsst : [mirthless]
fiiil : [filii]
ciorsuu : [curious]
cgikmno : [mocking]
adeghrstu : [daughters]
abceklnss : [blackness]
eegiilnrv : [relieving]
aiknnost : [atkinson]
aellnpr : [parnell]
aepssu : [pauses]
bginow : [bowing]
deginnr : [rending]
aepsss : [passes]
deginnw : [wending]
deginnt : [tending]
eelrssst : [restless]
girt : [grit]
aceiprst : [practise]
adhossw : [shadows]
cdeeipr : [pierced]
adeiinstt : [daintiest]
deeenrt : [entered]
aehilrty : [heartily]
alott : [total]
ehlls : [shell]
adeeimnrtt : [terminated]
bnorw : [brown]
ccceenorru : [occurrence]
adnsst : [stands]
acerttx : [extract]
addgilnsw : [swaddling]
ciinnorssttu : [instructions]
afgilmn : [flaming]
gitw : [twig]
abdekory : [keyboard]
ceemoorv : [overcome]
deikl : [liked]
aggilnnrst : [strangling]
afgilln : [falling]
adeeinprst : [pedestrian]
defitt : [fitted]
adeghrtu : [daughter]
ailmnno : [nominal]
aklst : [talks]
cdlos : [colds, clods]
aklsw : [walks]
ceorv : [cover]
cdlou : [could, cloud]
ceory : [royce]
gisw : [wigs]
adnsuy : [sunday]
cdeehkst : [sketched]
aeeginnorst : [generations]
abeehnoprry : [hyperborean]
bginrs : [brings]
cdeeinv : [evinced]
delpuzz : [puzzled]
cehhirs : [cherish]
ddeeeprss : [depressed]
amrry : [marry]
abceilorrvy : [irrevocably]
abrss : [brass]
aeflnnorttuuy : [unfortunately]
illqsu : [quills]
addemns : [demands]
dennorstuu : [untonsured]
amrsw : [swarm]
aeghmo : [homage]
demnor : [modern]
amrst : [smart]
cmmnnoou : [uncommon]
cdeenoqru : [conquered]
acdgiiiimnnrst : [discriminating]
abeeeilmnprt : [impenetrable]
ilpst : [split]
adeeggn : [engaged]
adehlt : [halted]
adehls : [lashed]
giijnnru : [injuring]
aginntw : [wanting]
adehln : [handle]
aehkmt : [maketh]
adgnnors : [grandson]
ceffiinstu : [sufficient]
aeinpr : [rapine]
amrtu : [turma]
ceeinns : [incense]
addeln : [landed]
addelr : [ladder]
ettx : [text]
ddeoppr : [dropped]
alory : [royal]
iprstuu : [pursuit]
aepprrw : [wrapper]
gmnooorrst : [strongroom]
aehkns : [shaken]
eeelmorrsss : [remorseless]
imsty : [misty]
bcddeeirs : [described]
borsw : [brows]
adinorsstw : [downstairs]
aginnrw : [warning]
aclnnortu : [nocturnal]
ceiklrt : [trickle]
aehkss : [shakes]
dgilnor : [lording]
aceehilortt : [theoretical]
ahinosst : [astonish]
ghinosw : [showing]
ffpuy : [puffy]
ghinosv : [shoving]
eimprt : [permit]
addenr : [dander]
aegmnry : [germany]
abeeistu : [beauties]
beeemmrr : [remember]
aeilllrty : [literally]
addemn : [damned, demand]
beginorsv : [observing]
eilmps : [simple]
bklu : [bulk]
ghinott : [tonight]
ahir : [hair]
aeinnottt : [attention]
ahlt : [halt, lath]
ahls : [lash]
acdrs : [cards]
ahlo : [halo]
bkoo : [book]
aaccehrrt : [character]
adejnruw : [underjaw]
ahll : [hall]
aeintv : [native]
adehss : [shades]
fimnoru : [uniform]
egimnorv : [removing]
deilppsu : [supplied]
aemnoorrst : [astronomer]
adehsw : [washed]
adehsv : [shaved]
deimnrs : [reminds]
eelmmnopty : [employment]
aiiinnoprst : [inspiration]
aciilnppr : [principal]
adellnouy : [unalloyed]
adehrr : [harder]
addeor : [adored]
adehrs : [shared]
aginnnt : [tanning]
adehrt : [thread]
einstv : [invest]
ahnt : [than]
bdinnu : [unbind]
eprsu : [purse]
eersv : [serve, verse]
deiknnss : [kindness]
ckost : [stock]
aaddllny : [landlady]
ccdeehk : [checked]
cegiinpr : [piercing]
ddeenoprs : [responded]
cimmnnoou : [communion]
aacehmnttt : [attachment]
bggiilno : [obliging]
aabeimnot : [abominate]
fnorst : [fronts]
aeintxy : [anxiety]
bginr : [bring]
aeinnosst : [sensation]
egillnqu : [quelling]
ahmr : [harm]
gghiilnt : [lighting]
ciilv : [civil]
ckory : [rocky]
acckr : [crack]
afltu : [fault]
adeehnst : [hastened]
aeilnottux : [exultation]
aeirs : [raise]
ddeiijnost : [disjointed]
ehikrs : [shriek]
aciilmnr : [criminal]
acepst : [aspect]
ahpt : [path]
afluw : [awful]
deiorww : [widower]
eemprsu : [presume]
adeehnpp : [happened]
eilnst : [listen, silent]
aeghnss : [gnashes]
ahot : [oath]
aaeeginprstx : [exasperating]
ddeeorsty : [destroyed]
aceprs : [scrape]
aadersw : [seaward]
egiilnort : [loitering]
ceennortu : [encounter]
dlloy : [oldly]
ahox : [hoax]
adegginrr : [regarding]
defgilnnoru : [floundering]
aeilv : [alive]
aflot : [aloft, float]
aeils : [aisle]
ceioprsu : [precious]
deeeinrstt : [interested]
fggiinorv : [forgiving]
aeiprr : [repair]
agors : [argos]
ckoos : [cooks]
aeelnsst : [lateness]
ddeippr : [dripped]
aaelnpprty : [apparently]
adeglnss : [gladness]
dfgilnos : [foldings]
begghiinnoru : [neighbouring]
dddeeenp : [depended]
aehltwy : [wealthy]
abceelrst : [bracelets]
dddeeenr : [reddened]
acdeeinorst : [considerate]
gginorw : [growing]
aamrstu : [sumatra]
aacfiinosstt : [satisfaction]
afginnorrt : [farrington]
aflstu : [faults]
acchnotu : [couchant]
dmooy : [moody]
ahtw : [what, thaw]
accht : [catch]
ahtt : [that]
accho : [coach]
aaeilmnprt : [parliament]
aaacceinnqtu : [acquaintance]
aabegimnrrss : [embarrassing]
aeilnpx : [explain]
eorrsstu : [trousers]
ahst : [hats]
ahsw : [wash]
eelorrvv : [revolver]
aehmnr : [herman]
clrsu : [curls]
aeflnorttuy : [fortunately]
abgilntt : [battling]
cceeemmnor : [recommence]
aairstwy : [stairway]
eeghilnstw : [lengthwise]
adenstt : [attends]
aaffirs : [affairs]
eeeprrsv : [preserve]
dehpsu : [pushed]
ceeeimnntt : [enticement]
eggor : [grego]
aefhilsst : [faithless]
abeent : [beaten]
agggilnrst : [straggling]
aeiinopprrst : [perspiration]
adelmms : [slammed]
denooprsu : [ponderous]
eisssu : [issues]
ahrry : [harry]
isstu : [suits]
eegilmnsy : [seemingly]
cciinnootv : [conviction]
adempst : [stamped]
aacers : [caesar]
deistu : [suited, duties]
acehhrtt : [thatcher]
deffgiinr : [differing]
aggnor : [grogan]
giilmnoorv : [livingroom]
ddemoo : [doomed]
beemmrs : [members]
ademprt : [tramped]
deissu : [issued]
ahrtw : [wrath]
abbgilmnooyz : [bamboozingly]
cdeinnostt : [discontent]
eeggor : [george]
ceeprst : [respect, spectre]
ccdeinnov : [convinced]
efhilnoosss : [foolishness]
cghinnpu : [punching]
amnotu : [amount]
iprt : [trip]
iprs : [rips]
bckllou : [bullock]
hmow : [whom]
abeerv : [beaver]
ahilopst : [hospital]
deegmm : [gemmed]
ahyz : [hazy]
eimst : [times]
adeehhistww : [whitewashed]
ccdnotu : [conduct]
iinoopst : [position]
beknor : [broken]
deglo : [lodge]
binory : [briony]
jstu : [just]
abdlory : [broadly]
ceffiilnstuy : [sufficiently]
deegls : [sledge]
deeglu : [deluge]
eisstu : [tissue]
eehlmoosw : [wholesome]
iptt : [pitt]
abklrsuw : [bulwarks]
aabbcirr : [barbaric]
ipty : [pity]
bghirt : [bright]
giinrrst : [stirring]
aagilmnnt : [malignant]
aabhiinntt : [inhabitant]
degghrsu : [shrugged]
bdginoor : [brooding]
cdeeffgu : [cuffedge]
bcdeekno : [beckoned]
aaacnrv : [caravan]
aadeimnt : [animated]
ipst : [tips]
dghiiinsstu : [distinguish]
deiorssu : [desirous]
ccekorrsw : [corkscrew]
aeenpprsw : [newspaper]
cdeloo : [cooled]
eeklnost : [skeleton]
cdelos : [closed]
cceflsssuu : [successful]
eghit : [eight]
censt : [scent, cents]
abdefiorr : [fireboard]
giimnoprv : [improving]
dehilrruy : [hurriedly]
ceeffo : [coffee]
acginrt : [tracing]
cdefiiit : [citified]
cdegiinorsv : [discovering]
amorru : [armour]
amorrw : [marrow]
abefiltuu : [beautiful]
deeiinnrttw : [intertwined]
aeginnortv : [renovating]
cehoos : [choose]
ceefft : [effect]
acginst : [casting]
ailnqrtu : [tranquil]
ceefir : [fierce]
aacillprrtuy : [particularly]
acginsu : [causing]
adeilsty : [steadily]
adhilnostu : [outlandish]
aegity : [gaiety]
cgiknoo : [cooking]
einnr : [inner]
amnors : [sarmon]
almrwy : [warmly]
deegssu : [guessed]
allotw : [tallow]
aaceeffinott : [affectionate]
ddeiv : [dived]
eiinnnostt : [intentions]
aabcgilnn : [balancing]
beilrty : [liberty]
aggilnz : [glazing]
aceillpruy : [peculiarly]
einos : [noise]
eirssst : [sisters]
acinnooort : [coronation]
enrrtu : [turner, return]
aaeeilmort : [ameliorate]
cdegiinnors : [considering]
acceelpsst : [spectacles]
ddeir : [dried]
abehnorrt : [abhorrent]
aceenpttx : [expectant]
aehpprs : [perhaps]
abeilstu : [suitable]
aennoy : [anyone]
dginoppr : [dropping]
aacelp : [palace]
cdeennott : [contented]
elmouv : [volume]
aceioprt : [operatic]
bdgiinrstu : [disturbing]
adegnrs : [dangers]
aacemr : [camera]
elmoty : [motley]
aeemmssst : [messmates]
eeoopprrsstu : [preposterous]
hiottuw : [without]
deloprst : [droplets]
dehir : [hired]
flnoorr : [forlorn]
abilrry : [library]
abdnoortuu : [roundabout]
aaelpps : [appeals]
cdeenoruv : [uncovered]
ceefilnorst : [reflections]
cchku : [chuck]
eeehillns : [hellenise]
bdeelmrt : [trembled]
abeeln : [enable]
acefrsu : [surface]
abiloorsu : [laborious]
ghiiknnntu : [unthinking]
aadgglr : [laggard]
aadhrz : [hazard]
eeiorvvw : [overview]
lruuxy : [luxury]
cdellu : [culled]
cdeennost : [consented]
ddeeg : [edged]
abdeirtttu : [attributed]
ilost : [toils]
aadennttt : [attendant]
ddeen : [ended]
adorstw : [towards]
dellor : [rolled]
aelmrsty : [masterly]
aeeimnnorstu : [mountaineers]
aeginu : [guinea]
aegint : [eating]
ghinst : [things, nights]
acehnsst : [snatches]
cdeenorsv : [conversed]
aeginr : [regain]
giknnow : [knowing]
gijkno : [joking]
ghimmnu : [humming]
eejmnnoty : [enjoyment]
aagilmnyz : [amazingly]
denrtu : [turned]
eggilnorw : [glowering]
deiostu : [outside]
acilmnop : [complain]
aehlrt : [lather]
beglnos : [belongs]
acffiilo : [official]
bdeelow : [elbowed]
biilmstuy : [sublimity]
bdeelov : [beloved]
eghnou : [enough]
eiorrsw : [worries]
denrsu : [nursed]
copr : [crop]
aqrstu : [quarts]
ccilnnoossu : [conclusions]
adelrstt : [startled]
aacrsttt : [attracts]
ceffiors : [officers]
ghost : [ghost]
noot : [onto]
ilops : [spoil]
hinpsu : [punish]
noos : [soon]
ghinpsu : [pushing]
copy : [copy]
aceginnor : [ignorance]
demoor : [moored]
iklls : [kills]
aegims : [images]
ainqttuy : [quantity]
dnopsu : [pounds]
alnps : [plans]
lmppu : [plump]
degglrstu : [struggled]
ghotu : [ought]
ceilnst : [clients]
aeeimnx : [examine]
aiinnorstt : [transition]
agghisw : [waggish]
bllu : [bull]
ehloosstt : [toothless]
adorsuu : [arduous]
adeipr : [repaid]
aciittvy : [activity]
ailp : [pail]
blot : [blot]
ails : [sail]
ailr : [liar]
ailm : [mail]
mpstu : [stump]
aegilnopprv : [overlapping]
eeggisstuv : [suggestive]
aiillmw : [william]
ghinop : [hoping]
ainsstu : [sustain]
aaeglsvy : [savagely]
abcehlor : [bachelor]
ortu : [tour]
giilmnnooops : [monopolising]
aeeimss : [siamese]
lmpsu : [lumps]
beegiilnv : [believing]
bceijnoost : [objections]
aaehlmnw : [whaleman]
aeinooprst : [operations]
blow : [blow, bowl]
adeisv : [advise]
ailt : [tail]
aegosvy : [voyages]
bcgiilmn : [climbing]
efmoprrs : [performs]
aikn : [akin]
deimmrt : [trimmed]
cdelru : [curled]
eervy : [every]
aabcddorr : [cardboard]
ghoru : [rough]
aaaginr : [niagara]
ccfilnot : [conflict]
orst : [sort]
orsu : [ours]
orsw : [rows]
beeilrrt : [terrible]
nrstu : [turns]
nopu : [upon]
chorsu : [chorus]
orss : [ross]
ccceeeiiinrstt : [eccentricities]
ceeinrstu : [centuries]
adeirv : [varied]
adeirs : [raised]
ginprss : [springs]
ainr : [rain]
aint : [aint]
cdeginorr : [recording]
ainp : [pain]
aehlsw : [whales]
aaggimnn : [managing]
deinprt : [printed]
eeeinnprst : [serpentine]
giknoy : [yoking]
nosw : [snow]
agghinn : [hanging]
aiinosttu : [situation]
giknop : [poking]
ainv : [vain]
dfoorx : [oxford]
dellpu : [pulled]
egillnsw : [swelling]
dginstu : [dusting]
cost : [cost]
acnorrsu : [rancours]
aimn : [main]
agimnssu : [assuming]
inoopt : [potion]
beemmr : [member]
aehltw : [wealth]
acdeinotu : [education]
nort : [torn]
oruy : [your]
norw : [worn]
adeitw : [waited]
cdeerstuy : [curtseyed]
egilnstt : [settling]
egillmns : [smelling]
chips : [chips]
enost : [stone, notes]
aipr : [pair]
adepprst : [strapped]
chipt : [pitch]
ehlmos : [holmes]
eeiimnnprtt : [impertinent]
begins : [begins]
aeeegnrss : [eagerness]
aeehistv : [heaviest]
bbennorssstu : [stubbornness]
adeoss : [odessa]
bdeios : [bodies]
blru : [blur]
aacddenv : [advanced]
aeegrstt : [greatest]
cilry : [cyril]
ceiimnooptt : [competition]
notu : [unto]
deilmoosu : [melodious]
arrsty : [starry]
notw : [town]
adeorr : [roared]
cdeiilnn : [inclined]
acfrs : [scarf]
aadgllruy : [gradually]
aeeillrtvy : [relatively]
eortw : [wrote, tower]
aehrst : [hearts]
aacdehtt : [attached]
eortu : [route, outer]
acdgiinrstt : [distracting]
dgiinopss : [disposing]
acfst : [facts]
deemnortt : [tormented]
aabcikrsst : [backstairs]
dgiinoprv : [providing]
aehrtt : [threat]
enorw : [owner]
aaeistt : [satiate]
aaegmnr : [manager]
aacfiorsstty : [satisfactory]
addennrstu : [understand]
aceffinot : [affection]
dlouw : [would]
bdeilo : [boiled]
abcin : [cabin]
aitw : [wait]
chill : [chill]
adiov : [avoid]
cdginorw : [crowding]
aelry : [early]
aegovy : [voyage]
aelrt : [later, alter]
agghilnu : [laughing]
ceeeginrt : [energetic]
aeflsy : [safely]
adeiklsw : [sidewalk]
cdinooprstu : [productions]
abehlortt : [betrothal]
eehintttw : [twentieth]
abcjo : [jacob]
fhinrsu : [furnish]
chikn : [chink, kinch]
aisv : [vias]
dghiimnt : [midnight]
acehmostu : [moustache]
aglruv : [vulgar]
enopr : [prone]
bdeeeilv : [believed]
enops : [opens]
defhiins : [finished]
aelsv : [slave]
adipr : [rapid]
chikt : [thick]
eorsw : [worse, swore]
aelst : [least, tales, stale, steal]
bceoort : [october]
cekort : [rocket]
cdeiilru : [ridicule]
adeenpprw : [enwrapped]
chinp : [pinch]
abckl : [black]
elnrsty : [sternly]
ailnnstty : [instantly]
acfny : [fancy]
lsuuz : [zulus]
aalnnoopst : [pantaloons]
jlloy : [jolly]
dlorw : [world]
abcln : [blanc]
deeffrsu : [suffered]
aacdeeimt : [emaciated]
eeimnnrtt : [interment]
aeluv : [value]
bgiimmnr : [brimming]
elmopsy : [employs]
accistu : [caustic]
adeeinnrssu : [unreadiness]
aelnt : [leant]
aelnr : [learn]
aelns : [lanes]
adeehpstw : [deathspew]
aceehrrty : [treachery]
aelnp : [panel, plane]
ceeorrv : [recover]
aelno : [alone]
cggiilnn : [clinging]
deeehlrst : [sheltered]
bdennottuu : [unbuttoned]
ginorstw : [worsting]
arrty : [tarry]
aefilnooprss : [professional]
adefillpy : [playfield]
addeehnr : [hardened]
adily : [daily]
acceimmnotu : [communicate]
adeeghrt : [gathered]
aademss : [amassed]
eopprr : [proper]
aeeflmrsuu : [measureful]
eeft : [feet]
eefs : [fees]
adenpps : [snapped]
eefr : [free]
fhis : [fish]
cdefinno : [confined]
eeiinqrsu : [enquiries]
aegimmnrst : [stammering]
agrvy : [gravy]
abeghinrt : [breathing]
adimt : [admit]
eefl : [feel]
aelpt : [leapt]
aelpp : [apple]
hnor : [horn]
eeghinrtvy : [everything]
abcelmrs : [scramble]
dhijtu : [judith]
aelqu : [equal]
ddeeirtv : [diverted]
befir : [brief]
eelopp : [people]
aaccillss : [classical]
aefgistu : [fatigues]
hopsy : [hypos]
aachimnr : [chairman]
hopss : [shops]
eehr : [here]
acorss : [across]
acdeiilnt : [identical]
adeefimnst : [manifested]
eforst : [softer, foster]
irstw : [wrist]
ahiilrty : [hilarity]
eeklny : [keenly]
eefginrz : [freezing]
abelorrsu : [labourers]
cdeloor : [colored]
cemostu : [costume]
aeflln : [fallen]
ccghinors : [scorching]
eegl : [glee]
ccghinoru : [crouching]
bdirstu : [disturb]
abceeelmnrs : [resemblance]
adeisttu : [situated]
abeggrs : [beggars]
cdeeinprsy : [presidency]
aehrrt : [rather]
hikswy : [whisky]
abloru : [labour]
acddeiint : [indicated]
efnorz : [frozen]
bdeiru : [buried]
cdeeiltxy : [excitedly]
degnnosu : [dungeons]
aacfgiiinortt : [gratification]
cdelnooruy : [euroclydon]
afhlmru : [harmful]
aelnquu : [unequal]
gnsuw : [swung]
aelly : [alley]
ceeimnps : [specimen]
glmoo : [gloom]
hnsu : [shun]
aeepprr : [prepare]
hortwy : [worthy]
acgilln : [calling]
aacgisty : [sagacity]
agrsu : [sugar]
aelmt : [metal]
agrss : [grass]
efgoy : [fogey]
ccimnnooptu : [compunction]
enosst : [stones]
acefhmnnr : [frenchman]
ablott : [talbot]
beiiilnssty : [sensibility]
cimmot : [commit]
aensuy : [uneasy]
adeiimnrs : [meridians]
ainrssu : [russian]
adehntu : [haunted]
eels : [else]
eelr : [leer]
eelp : [peel]
fhoo : [hoof]
aeehirv : [heavier]
abclmnosuu : [columbanus]
efhls : [shelf, flesh]
aeeglrtu : [regulate]
aefgmnrt : [fragment]
ddeiltu : [diluted]
aacddeinst : [candidates]
eekw : [week]
eeks : [seek]
eekr : [reek]
eekp : [keep]
ehntt : [tenth]
eekn : [keen, knee]
eekm : [meek]
deilos : [soiled]
aeerrstu : [treasure]
ddeflo : [folded]
aginppt : [tapping]
hntu : [hunt]
aabdegn : [bandage]
ciosst : [stoics]
dgnoru : [ground]
eenv : [even]
eens : [seen]
aaennprrstt : [transparent]
eiqtu : [quite, quiet]
deoppssu : [supposed]
celmssu : [muscles]
beeentw : [between]
ddiruy : [druidy]
acilmsty : [mystical]
aelmnt : [mental]
acgiknt : [tacking]
imnost : [inmost]
eemt : [meet]
eems : [seem]
eemr : [mere]
deilms : [smiled]
aegnors : [noserag]
ehnry : [henry]
adhnosstu : [thousands]
cdiinnoot : [condition]
bcikrs : [bricks]
eelnvy : [evenly]
deeefhrrs : [refreshed]
deiltt : [tilted]
ekmnoy : [monkey]
abbggiln : [gabbling]
deiltw : [wilted]
acmorstuy : [customary]
cgimno : [coming]
eepw : [weep]
aegmnrstu : [arguments]
abeklnst : [blankets]
ginrty : [trying]
ehnoy : [honey]
bennot : [bonnet]
aceemnnnnotu : [announcement]
dstuy : [study, dusty]
aegmmoprr : [programme]
dfnou : [found]
eopprssu : [purposes]
ccegillnot : [collecting]
amntuu : [autumn]
ccdeesu : [succeed]
egiiklnw : [winglike]
deeelns : [needles]
ginrst : [string]
aceinnst : [instance]
adehnru : [unheard]
eerw : [were]
aacinpt : [captain]
adefhls : [flashed]
eerv : [ever]
cdeiorsvy : [discovery]
bdgiiinrsttu : [distributing]
dekop : [poked]
eeinrsstt : [interests]
dehinr : [hinder]
addeegrr : [regarded]
cdeekrw : [wrecked]
aelmry : [marley]
aceinnrs : [crannies]
ghiins : [hising]
giknorw : [working]
gghinosu : [soughing]
dehint : [hinted]
adfhlost : [holdfast]
deilnpru : [underlip]
beginrw : [brewing]
accdginor : [according]
aaeppr : [appear]
aeehrr : [hearer]
aeenorsst : [reasonest]
aeehrs : [hearse]
affhiltu : [faithful]
iinqruy : [inquiry]
aabgiilnor : [aboriginal]
cceilr : [circle]
cdeimmooprs : [compromised]
eimnoot : [emotion]
acddehnnos : [secondhand]
aeehikz : [ezekiah]
eesy : [eyes]
eesv : [eves]
ceegiinprv : [perceiving]
degilmn : [mingled]
cdeeikopst : [sidepocket]
hilpprsu : [purplish]
acegiknr : [creaking]
accdeloorsttt : [cattledoctors]
eeillnosssy : [noiselessly]
eginrsv : [serving]
dehisw : [wished]
gijklmu : [milkjug]
ceeiprs : [precise]
aacehilmpsty : [metaphysical]
abdeeilrs : [desirable]
aiklmmnow : [milkwoman]
ceeiprt : [receipt]
aaderrrw : [rearward]
ostw : [twos]
chirsty : [christy]
eehsst : [sheets]
hiopstu : [photius]
aaccillprty : [practically]
bbcdeilrs : [scribbled]
egillns : [selling]
egillnt : [telling]
iimnoss : [mission]
clmmnnoouy : [uncommonly]
deghilt : [lighted, delight]
ccklo : [clock]
osst : [toss]
cdeelmow : [welcomed]
aaeilnortx : [relaxation]
cekopt : [pocket]
dstu : [dust]
ahnoopr : [harpoon]
agimnrry : [marrying]
chitw : [witch]
ddeflnou : [unfolded]
ccceenorrsu : [occurrences]
dilryzz : [drizzly]
degiimnnr : [reminding]
abeeilnoqstu : [questionable]
deiinprt : [intrepid]
deiinprs : [inspired]
aiiimnnott : [intimation]
ginopru : [pouring]
cpsu : [cups]
addenrst : [stranded]
accgiiilnnot : [conciliating]
aadefgrsu : [safeguard]
beimmrrs : [brimmers]
aciilmosu : [malicious]
acdeeeinnorssst : [considerateness]
aabddehor : [headboard]
aeeilrr : [earlier]
aeeilrs : [realise]
defttu : [tufted]
adeehirrty : [hereditary]
aemoprrty : [temporary]
dehlorw : [whorled]
bmpu : [bump]
aacinorttt : [attraction]
egilmpss : [glimpses]
deiorst : [editors, storied]
ccdeeno : [concede]
deinopt : [pointed]
cdeeeeinprx : [experienced]
einoprrss : [prisoners]
aginpsu : [pausing]
aginpss : [passing]
enovw : [woven]
imorrr : [mirror]
imorrs : [morris]
imnoot : [motion]
eegilnps : [sleeping]
begilnsss : [blessings]
aginpry : [praying]
aginprs : [rasping]
aceno : [ocean]
aaciosttw : [waistcoat]
chhnu : [hunch]
aghinnty : [anything]
imorrrs : [mirrors]
cikqu : [quick]
ggiinnprs : [springing]
aalrsuz : [lazarus]
aeinrtt : [nitrate]
beelr : [rebel]
aiilmrs : [similar]
cikpr : [prick]
aceensstx : [exactness]
ademntu : [untamed]
aefflru : [fearful]
adhry : [hardy]
abgiimnnoo : [mabinogion]
cdekkno : [knocked]
aenssstv : [vastness]
cikps : [picks]
effginoprr : [proffering]
eglnorsu : [loungers]
llowy : [lowly]
cikst : [stick]
flloow : [follow]
aceps : [space, paces]
bdehlo : [behold]
ccdeehln : [clenched]
acefllnoorsttw : [wollstonecraft]
acimnnoops : [companions]
adhsy : [shady]
aesstt : [tastes]
aaceiipprtt : [participate]
ablprtuy : [abruptly]
aegpru : [prague]
cklnou : [unlock]
bbnorstu : [stubborn]
ajsw : [jaws]
cikrt : [trick]
accdekr : [cracked]
accehns : [chances]
ennpy : [penny]
aacegiinnrst : [ascertaining]
bggiinnr : [bringing]
adeinsstu : [sustained]
aadelnz : [zealand]
accdehn : [chanced]
aekps : [speak, peaks, spake]
einnst : [tennis]
ddeenrssu : [undressed]
adeehlrt : [lathered]
ccdeko : [cocked]
defimnor : [informed]
bdehin : [behind]
aadelmr : [alarmed]
aaeinopsst : [passionate]
cikls : [licks]
aekqu : [quake]
acekr : [creak]
adhns : [hands]
einntt : [intent]
addiiilnuv : [individual]
deeginprss : [depressing]
chhiw : [which]
gghiilnnst : [lightnings]
adhny : [handy]
eegoqrstu : [grotesque]
deemrsu : [resumed]
abeeilmrs : [miserable]
aceln : [clean, lance]
cdgiinnortu : [introducing]
acelp : [place]
cnortuy : [country]
deffilllu : [fulfilled]
deelopv : [develop]
aeelpprtu : [perpetual]
acelr : [clear]
giilnptyy : [pityingly]
bcenou : [bounce]
aehlrty : [earthly]
adhor : [hoard]
eilorssuy : [seriously]
abbir : [rabbi]
abddenr : [branded]
acdeiinnoorst : [consideration]
ahiilopstty : [hospitality]
eginptt : [petting]
aceersss : [caresses]
aegiilnnpx : [explaining]
ahnstu : [haunts]
eeemrtx : [extreme]
cdiinstt : [distinct]
aekst : [takes, stake]
aglnoru : [languor]
aeenopru : [european]
adeeginr : [regained]
cdddeeens : [descended]
aeinrst : [retains]
aelnortt : [tolerant]
eeghilmnorvw : [overwhelming]
aadelry : [already]
aeegnprsss : [passengers]
effj : [jeff]
deforst : [frosted]
abbcy : [cabby]
egisv : [gives]
acefs : [faces]
lstuy : [lusty]
mosttu : [utmost]
abdehrt : [breadth]
cdeeitx : [excited]
adeenrstuv : [adventures]
eeelmopsy : [employees]
ehhirtw : [whither]
acdeinst : [distance]
aceerr : [career]
aekms : [makes]
acegr : [grace]
acffirt : [traffic]
ehhirtt : [thither]
effor : [offer]
acehl : [hecla]
aadginru : [guardian]
cdeeisv : [devices]
acehr : [reach]
aceht : [teach]
aekns : [snake]
acehs : [chase]
aeknt : [taken]
acehp : [cheap]
defnorw : [frowned]
cdeehrtw : [wretched]
acdeghlnost : [ghostcandle]
glno : [long]
aeeinrrtvy : [veterinary]
cdeeirt : [recited]
abdeinsu : [unbiased]
cerssw : [screws]
ceeetux : [execute]
afnrz : [franz]
hops : [hops]
beegt : [beget]
cdeinnotu : [continued]
eghilsstt : [slightest]
adeegirt : [gaitered]
dginnorrsuu : [surrounding]
deimno : [monied]
fimr : [firm]
fghhlottuu : [thoughtful]
deopppr : [propped]
deimnr : [remind]
agiinnprs : [spraining]
ddegil : [gilded]
eelpsy : [sleepy]
gnruw : [wrung]
eelorssuvy : [yourselves]
ghinoost : [shooting]
cdeiinoprst : [description]
host : [shot]
glpu : [plug, gulp]
ddegiu : [guided]
hosw : [show]
ddegir : [girded]
eelpss : [sleeps]
ehinnorsstuw : [unworthiness]
efiw : [wife]
hoopt : [photo]
efiv : [five]
afgiiln : [failing]
filt : [lift]
adeppt : [tapped]
efir : [fire]
adeppr : [rapped]
deimmu : [medium]
eioprsuv : [previous]
efin : [fine]
film : [film]
ghlosty : [ghostly]
efil : [life]
fill : [fill]
eginy : [eying]
eginw : [gwine]
aaccnnottu : [accountant]
eginv : [given]
cdeeeinv : [evidence]
aeeemprrttu : [temperature]
ddegju : [judged]
deipr : [pride]
horu : [hour]
imnoost : [motions]
deipt : [tepid]
imnoosu : [ominous]
glow : [glow]
eejjnu : [jejune]
deipw : [wiped]
deiiinprst : [inspirited]
aabccelnnotuu : [unaccountable]
eeinoprssx : [expression]
aceelrr : [clearer]
horstw : [throws]
eflw : [flew]
adepsu : [paused]
eflt : [felt, left]
efls : [self]
eehhrtw : [whether]
efll : [fell]
beghnu : [behung]
afhmost : [fathoms]
deiss : [sides]
adepss : [passed]
dgiiooprsu : [prodigious]
deisv : [dives]
cdeinortu : [introduce]
cdeinortv : [contrived]
iillmnos : [millions]
giiknrst : [striking, skirting]
adepry : [prayed]
beeqstu : [bequest]
adeprt : [parted, depart]
fins : [fins]
aefhrrt : [farther]
aceep : [peace]
cdeeeittv : [detective]
eehlopss : [hopeless]
gnrtu : [grunt]
cellosy : [closely]
deiprrssu : [surprised]
deoppst : [stopped]
hotu : [thou]
cdeiinorst : [directions]
adeprs : [spread]
irwy : [wiry]
deirt : [tried, tired]
cceeinov : [conceive]
deirv : [drive]
deirw : [weird]
aacktt : [attack]
aginprsssu : [surpassing]
cdeiprtu : [pictured]
abekrs : [breaks]
cffino : [coffin]
bdeeirstw : [birdsweet]
aeelnrsty : [earnestly]
acgilnp : [placing]
aelnry : [nearly]
eeinnps : [pennies]
adlmopsy : [psalmody]
aeilmoprrty : [temporarily]
aabdeginr : [bargained]
ceegintux : [executing]
efgir : [grief]
ceilnpry : [princely]
cdeeeirv : [received]
aabdder : [abraded]
accdgilnory : [accordingly]
eeinnst : [intense]
acefgiimnnt : [magnificent]
bcdeeeino : [obedience]
aadiimnort : [admiration]
fist : [fits]
cddgilno : [clodding]
aabeilmmrsuy : [immeasurably]
ehmor : [homer]
ehmos : [homes]
chloos : [school]
deeelnopv : [enveloped]
aeiiprrs : [prairies]
abiimnot : [ambition]
agimnno : [moaning]
aeflnru : [funeral]
ceeffno : [offence]
efos : [foes]
eipss : [spies]
eipst : [spite]
aaaeghillnn : [alleghanian]
ddeglo : [lodged]
eiiinttuv : [intuitive]
aeeikpprsss : [spearspikes]
aehimpst : [shipmate]
agginrt : [grating]
acerstt : [scatter]
bcejost : [objects]
gluy : [ugly]
acegilnno : [congenial]
acddehinsw : [sandwiched]
aeginrstu : [signature]
aefnnorttuu : [unfortunate]
bbbegilnru : [blubbering]
acghinr : [charing, chagrin]
akmrs : [marks]
aaccilnooptu : [occupational]
bcdeinorttu : [contributed]
gimnov : [moving]
acersst : [actress]
deefloorvw : [overflowed]
eegnnorst : [snotgreen]
cdoort : [doctor]
aceinort : [reaction, creation]
adeglnn : [england]
cdioorrr : [corridor]
adeglnt : [tangled]
aceens : [seneca]
abdeinorsstu : [subordinates]
eipqu : [pique]
boswy : [bowsy]
eeeqrstu : [queerest]
aabeglr : [algebra]
ceeffst : [effects]
cfmoort : [comfort]
addlnoosw : [woodlands]
abellostuy : [absolutely]
cffils : [cliffs]
bdeisstttuu : [substituted]
ghinrsu : [rushing]
ceiprrstu : [scripture]
abcers : [braces]
anorrw : [narrow]
deimss : [missed]
aadeeknw : [awakened]
aelnty : [neatly]
ailnrsu : [insular]
ddgiy : [giddy]
ceelnopu : [opulence]
aabellpp : [palpable]
ggiinnr : [ringing]
ggiinns : [singing]
aceeps : [escape]
aelntt : [talent]
adeefnrrrst : [transferred]
aaceirtttv : [attractive]
addelsu : [dedalus]
aceeginrv : [grievance]
bnor : [born]
acdeeglno : [congealed]
deeenopr : [reopened]
abehlottw : [bathtowel]
deggtu : [tugged]
cdefmoort : [comforted]
eghimnost : [something]
aaprt : [apart]
aklw : [walk]
eimostv : [motives]
dtuy : [duty]
llopy : [polly]
efgilnrttu : [fluttering]
beggist : [biggest]
aklt : [talk]
ceeehinrss : [cheeriness]
dgilmnpsu : [dumplings]
aegmnrst : [garments]
eorrstu : [trouser]
abceem : [became]
bdeginnnu : [unbending]
acdgiiinnt : [indicating]
aefgmnrst : [fragments]
deggru : [rugged]
ginpttu : [putting]
akns : [sank]
alpsy : [plays]
aknr : [rank]
morst : [storm]
adeirst : [astride]
aciilmnrs : [criminals]
aciostuu : [cautious]
aabefloruv : [favourable]
aaceimnr : [american]
ahmost : [thomas]
hrsttu : [thrust]
ceknor : [reckon]
aceghinr : [reaching]
hinsy : [shiny]
deilnosu : [delusion]
aceghint : [cheating]
aknt : [tank]
achimrsst : [christmas]
ddeerss : [dressed]
akmr : [mark]
adeirrv : [arrived]
acehmnrst : [merchants]
hioprsw : [worship]
mnot : [mont]
abekmr : [embark]
acimnnoop : [companion]
adeeglnnr : [greenland]
aceerrtu : [creature]
deilnotu : [outlined]
adeeglnnt : [entangled]
akms : [mask]
acert : [crate]
acers : [scare, cares]
akpr : [park]
ceeeimnttx : [excitement]
achnpu : [paunch]
acejkst : [jackets]
aiprst : [patris]
accehst : [catches]
aeehmoprst : [atmosphere]
aabelluv : [valuable]
abeknr : [banker]
ahrstwy : [swarthy]
eggintt : [getting]
eegiknp : [keeping]
acesu : [cause]
achnor : [anchor]
cinosu : [cousin]
acess : [cases]
cdegilnooruv : [overclouding]
deerst : [rested]
adefiisst : [satisfied]
aghhlotu : [although]
deersv : [served]
llost : [tolls]
agiiilnnopt : [oilpainting]
adeehmmr : [hammered]
deilnovv : [involved]
ghillty : [lightly]
aenprrst : [partners]
ginoqtu : [quoting]
acetu : [acute]
acetx : [exact]
cghiot : [gothic]
delnnopssu : [nonplussed]
adehinsv : [vanished]
ceeprsst : [respects]
elpruy : [purely]
fiillptuy : [pitifully]
agimnrw : [warming]
deiinqru : [inquired]
ekorsst : [strokes]
aapps : [papas]
ceefnopru : [fourpence]
ginnnru : [running]
alpps : [palps]
amsst : [masts]
iinnorsstu : [intrusions]
alppy : [apply]
adgilnnort : [darlington]
aeegnprss : [passenger]
aaenpst : [peasant]
deginnps : [spending]
cdehittw : [twitched]
aefgiilnnrs : [fingernails]
beest : [beset]
eghhit : [height]
ejnorsuy : [journeys]
acegilnr : [clearing]
ccehio : [choice]
eimmmsu : [mummies]
eghhir : [higher]
ccfiirux : [crucifix]
aegmnr : [german]
achtw : [watch]
aaehilntv : [leviathan]
aeginrt : [tearing]
bdeow : [bowed]
eghinw : [whinge, hewing]
agimnprt : [tramping]
aefilnnr : [infernal]
aeginrw : [wearing]
abers : [bears]
aehimpsst : [shipmates]
eilppssu : [supplies]
acelnnu : [unclean]
ademns : [amends]
akst : [task]
akss : [asks]
aehprr : [harper]
abeimnnsssu : [businessman]
aehprs : [phrase]
aberv : [brave]
beggir : [bigger]
agimnpst : [stamping]
aacfiilnn : [financial]
aeeinnortv : [veneration]
beeillorsu : [rebellious]
dehmost : [methods]
orrwy : [worry]
aciloopst : [apostolic]
abesu : [abuse]
adinorry : [ordinary]
ddeeotv : [devoted]
arsttu : [stuart]
ceeinost : [coenties]
eoopprs : [propose]
aeinqtu : [antique]
eopssss : [possess]
deefiilnty : [definitely]
adiiprty : [rapidity]
ghillsty : [slightly]
bdegir : [bridge]
bddelnu : [bundled]
aeeggn : [engage]
diklny : [kindly]
ceginoprtt : [protecting]
aeimnrr : [mariner]
aeimnrs : [remains]
ccdeeehkr : [checkered]
deeghilnw : [wheedling]
knnow : [known]
aeeglr : [regale]
aeeglu : [league]
abemr : [amber]
abems : [beams]
achpt : [patch]
accnorstt : [contracts]
aabbehilt : [habitable]
afflloot : [footfall]
abemy : [maybe]
aefghhoorrtu : [thoroughfare]
ilopsuy : [piously]
glmooy : [gloomy]
fhortu : [fourth]
cceemnnnort : [concernment]
ademss : [massed]
defilnry : [friendly]
beiiilnoprssty : [responsibility]
eelmopry : [employer]
aeeorrsv : [averroes]
ademry : [dreamy]
ademrw : [warmed]
chkos : [shock]
aehmttw : [matthew]
deeeprssx : [expressed]
ademrs : [dreams]
ceinooprtt : [protection]
emnno : [menno]
ceeeinstx : [existence]
cghou : [cough]
eehlllpssy : [helplessly]
aeeeimnnnrttt : [entertainment]
abeov : [above]
einoss : [noises]
ceeistx : [excites]
eghitw : [weight]
cdeeglnos : [secondleg]
hloost : [sholto]
abdhnsu : [husband]
eeloprx : [explore]
adennoy : [annoyed]
hiilrstty : [thirstily]
emnow : [women]
ehklsw : [whelks]
gggilnrstu : [struggling]
emnoy : [money]
lrtuy : [truly]
adeeilnt : [entailed]
acelorrs : [corlears]
ccdehku : [chucked]
adeehnors : [hoarsened]
aeginsu : [guineas]
dknru : [drunk]
aeeghinnrtt : [threatening]
bdens : [bends]
eghu : [huge]
bdegu : [budge]
ddei : [died]
acdddeeit : [dedicated]
cdersu : [cursed]
bceeehrs : [breeches]
dnoorsuw : [wondrous]
istu : [suit]
eeerrsv : [reserve, reverse]
eoprsv : [proves]
eoprst : [topers]
dddeew : [wedded]
achmr : [march, charm]
ccefllsssuuy : [successfully]
abejz : [jabez]
adeginntt : [attending]
eefrv : [fever]
ddeeiprv : [deprived]
dehilops : [polished]
abders : [beards]
isst : [sits]
eoprsw : [powers]
ddegnnorruu : [underground]
abekl : [bleak]
achnt : [chant]
degiilnt : [diligent]
aeellrrtv : [traveller]
abekr : [baker, break]
cefmnoorssu : [confessorum]
beeilnss : [sensible]
hpsu : [push]
deeinprst : [president]
eelqsu : [sequel]
eefghilnrrsy : [refreshingly]
eehilnprs : [replenish]
bdeir : [bride]
egiv : [give]
aceflru : [careful]
abelt : [table]
aceeemnprt : [temperance]
cdeeefft : [effected]
deelnss : [endless]
acghtu : [caught]
acdeginy : [decaying]
achos : [chaos]
acdeginu : [guidance]
abelz : [blaze]
ddenorrsuu : [surrounded]
deeorrst : [restored]
adeeilrs : [realised]
adeginnrw : [wandering]
eeopsssss : [possesses]
deinpp : [nipped]
egls : [legs]
acegott : [cottage]
belmopr : [problem]
blmossy : [symbols]
efiry : [fiery]
acessu : [causes]
denorsw : [wonders]
eefgilns : [feelings]
aeginnr : [earning]
ddeiknr : [kindred]
hnosw : [shown]
adehlss : [slashed]
deghis : [sighed]
biinosstttuu : [substitution]
achir : [chair]
ceikqru : [quicker]
eeeeginvv : [genevieve]
achin : [chain, china]
aabdeefgiilnt : [indefatigable]
acfiilty : [facility]
beilrtty : [bitterly]
ceoorstuu : [courteous]
aaelnnpstu : [unpleasant]
eilnoorstu : [resolution]
cdeinosst : [consisted]
acegoru : [courage]
abehioruv : [behaviour]
eoprrt : [report]
aallnrtuy : [naturally]
beghinrsst : [brightness]
hnort : [north]
aalswy : [always]
cefginnoss : [confessing]
deinnt : [intend]
egno : [gone]
deinns : [sinned]
deinnr : [dinner]
abegn : [began]
accnotu : [account]
accnott : [contact]
aaaginnopt : [patagonian]
bdeel : [debel]
ddeikln : [kindled]
ddehin : [hidden]
hortw : [throw, worth]
ajlnoru : [journal]
bdehilpsu : [published]
eflrstu : [restful]
adeellrtv : [travelled]
adknr : [drank]
eeegmnrsss : [messengers]
abcdeeellt : [delectable]
achkw : [whack]
adeehisv : [adhesive]
aemnnr : [manner]
deintu : [united]
aehrsvw : [wharves]
aabdeilmr : [admirable]
aegilnprs : [relapsing]
ddeilnps : [splendid]
efiiinnt : [infinite]
ddehoo : [hooded]
abdeit : [baited]
addeinr : [drained]
eeiiiinnqssstuv : [inquisitiveness]
deiilmrsu : [deliriums]
hostu : [shout, south]
deinsy : [sidney]
egos : [goes]
adehlot : [loathed]
deiintv : [invited]
chiklty : [thickly]
fghiinorry : [horrifying]
acinst : [antics]
emmmruy : [mummery]
egry : [grey]
egrw : [grew]
beertt : [better]
egru : [urge]
ceeimnpss : [specimens]
elpssu : [pulses]
deinrv : [driven]
aginrst : [staring]
beprsu : [superb]
emnorst : [monster]
ceeeflpprrttu : [pluterperfect]
cgilnooru : [colouring]
adeginr : [grained, reading]
accefiirs : [sacrifice]
ahmpstyy : [sympathy]
acgiklnn : [clanking]
eeffint : [fifteen]
agggins : [sagging]
cellruy : [cruelly]
acdeprs : [scraped]
cdeeeorrv : [recovered]
eegnr : [green]
aginrrw : [warring]
adeeghinrstt : [straightened]
aggginr : [ragging]
ceilmmnopt : [compliment]
eijstu : [jesuit]
emnortt : [torment]
agstuu : [august]
acdhinsw : [sandwich]
adeenrrtuv : [adventurer]
ceeflprty : [perfectly]
eehmoprstu : [prometheus]
aceglmnry : [clergyman]
aceeefinoprtt : [perfectionate]
adelnrty : [ardently]
effginor : [offering]
bghotu : [bought]
aaenpprt : [apparent]
cefnor : [confer]
elmorstuu : [tremulous]
accelmmnoops : [commonplaces]
eflorsuy : [yourself]
aceinptt : [pittance]
cgiiknt : [ticking]
efirtuv : [furtive]
cgiiknp : [picking]
adeehorrv : [overheard]
egst : [gets]
deeffinrt : [different]
eehiorst : [theorise, theories]
ccdelnou : [conclude]
eistu : [suite]
abhhmoorrtuu : [harbourmouth]
cdiilnstty : [distinctly]
eistx : [exist]
dddeno : [nodded]
allw : [wall]
abehrt : [breath]
demsu : [mused]
allt : [tall]
aceelrss : [careless]
opprstu : [support]
addeilmnst : [dismantled]
deefmor : [freedom]
aceiilpsst : [specialist]
cceersy : [secrecy]
aacefgnrr : [fragrance]
aacciilmnrsttu : [circumstantial]
alnp : [plan]
alno : [loan]
aceilnrty : [certainly]
achmost : [stomach]
mopp : [pomp]
noops : [spoon]
blmoo : [bloom]
eegrrt : [regret]
nrsu : [runs]
adeeegimnrst : [disagreement]
agiillnory : [originally]
alnw : [lawn]
bceijnoot : [objection]
clooru : [colour]
afilry : [fairly]
adeluv : [valued]
crtu : [curt]
egilnpt : [pelting]
aagiintw : [awaiting]
aefirr : [fairer]
almp : [palm, lamp]
deiklnrw : [wrinkled]
iisstv : [visits]
acdiiinnost : [indications]
ceeirsv : [service]
ccinoossu : [conscious]
eissu : [issue]
deeiinopstx : [expeditions]
moor : [room]
begilmnrt : [trembling]
ahortt : [throat]
blmpu : [plumb]
aainssstt : [assistant]
deeeghlnnt : [lengthened]
boss : [boss]
demov : [moved]
aggiiimnns : [imaginings]
aeglrv : [gravel]
ceeelnrssv : [cleverness]
aiillnqrttuy : [tranquillity]
aeglrr : [larger]
aabdilmry : [admirably]
llor : [roll]
flnoopsu : [spoonful]
eeelnv : [eleven]
ahnopr : [orphan]
alpy : [play]
bosy : [boys]
eerrsv : [server]
bosw : [bows]
deghsu : [gushed]
alos : [also]
aeenpprssw : [newspapers]
deiklntw : [twinkled]
gikmnos : [smoking]
deegilnst : [glistened]
belmoprs : [problems]
acilostuuy : [cautiously]
gilnos : [losing]
gilnov : [loving]
annrtyy : [tyranny]
nrtu : [turn]
giloorsuvy : [vigorously]
borw : [brow]
cellnoorssu : [counsellors]
ginortt : [rotting]
alov : [oval]
abdeerty : [betrayed]
deopru : [poured]
deoprv : [proved]
abdeem : [beamed]
eeelps : [sleepe]
cdiijlosuuy : [judiciously]
degginnoru : [undergoing]
aeimnst : [inmates]
eimoprs : [promise]
ddeeorr : [ordered]
aacdeefmt : [meatfaced]
beeryz : [breezy]
acelnrt : [central]
deioprv : [provide]
adilpry : [rapidly]
cdddeeily : [decidedly]
most : [most]
abdefl : [fabled]
llpu : [pull]
acefllruy : [carefully]
afiimnnoort : [information]
ilmpsy : [simply]
acegimnt : [magnetic]
alsuu : [usual]
abegiknr : [breaking]
orrsy : [sorry]
eehkloy : [keyhole]
deoppp : [popped]
akprs : [spark]
cderstu : [crusted]
abdegg : [bagged]
dehmptu : [thumped]
alst : [last, salt]
einrssu : [sunrise]
ddeeenprt : [pretended]
eorrttu : [torture]
egilno : [legion]
iillmno : [million]
aacdeinqtu : [acquainted]
abdeht : [bathed]
ilnstu : [insult]
egilns : [single]
egilnr : [linger]
abdor : [broad, board]
afinnt : [infant]
cdeiinnst : [incidents]
abelmprsuy : [presumably]
aeghlrstu : [slaughter]
adghrtu : [draught]
aacegirr : [carriage]
abdeffl : [baffled]
fghilnsu : [flushing]
adeeimnx : [examined]
afiilmnorty : [informality]
aehlpsy : [shapely]
glnorsty : [strongly]
bbeorry : [robbery]
adeeimnr : [remained]
aiinossttu : [situations]
beilmo : [mobile]
celost : [closet]
aelnoprs : [personal]
iimorssu : [missouri]
knnnouw : [unknown]
cehipst : [pitches]
abeehiltz : [elizabeth]
enpst : [spent]
cdeeeirsx : [exercised]
aegimnn : [meaning]
beillt : [billet]
bbgiilnn : [nibbling]
adeoottt : [tattooed]
ehilsstw : [whistles]
acdennnou : [announced]
abdrs : [bards]
adenrw : [warned, wander]
beeeilrv : [believer]
deopst : [posted]
aegnor : [orange]
cdeeilmnoopx : [complexioned]
aeegiinsttv : [investigate]
dgiiknnr : [drinking]
aabbeelnru : [unbearable]
adenrt : [ardent]
accnostu : [accounts]
abddeiors : [sideboard]
adeorst : [roasted]
adeorsu : [aroused]
eostv : [stove]
aeehnv : [heaven]
afinru : [unfair]
beglu : [bulge]
bginnottu : [buttoning]
celopu : [couple]
ahmnos : [hansom]
eimoprrs : [primrose]
alyz : [lazy]
cekopst : [pockets]
ddelnsuy : [suddenly]
abdly : [badly]
aaeilnopssty : [passionately]
acchilmops : [accomplish]
adentw : [wanted]
ddeegins : [designed]
adentt : [attend]
eimoprss : [promises]
dees : [seed]
deep : [deep]
deen : [need]
cccinstu : [succinct]
deem : [deem]
adeilnnrs : [inlanders]
deeg : [edge]
cimsu : [music]
aimnrstt : [transmit]
cdffiiltuy : [difficulty]
eiprrssu : [surprise]
celors : [closer]
cfginor : [forcing]
aeggglu : [luggage]
cdeinorsttu : [destruction]
begnu : [begun]
deeenpss : [deepness]
accfiip : [pacific]
abdns : [bands]
abehimo : [bohemia]
fhilorsu : [flourish]
ddeilly : [illdyed]
degiillnty : [diligently]
giiklnnt : [tinkling]
ginoppst : [stopping]
degiimnp : [impeding]
abdefor : [forbade]
eefistv : [festive]
adegmmru : [rummaged]
efhty : [hefty]
adeerstyy : [yesterday]
ehir : [hire]
defr : [fred]
bcekkooopt : [pocketbook]
fklo : [folk]
defl : [fled]
aellvy : [valley]
eprssu : [purses]
alnorrwy : [narrowly]
cceinnoossssu : [consciousness]
gnos : [song]
bghmuu : [humbug]
eelrtt : [letter]
begin : [being, begin]
bdfllotuuy : [doubtfully]
fghiilnorssu : [flourishings]
deiw : [wide]
deit : [tide, tied]
deir : [ride]
deis : [side]
adeellsst : [tasselled]
fkor : [fork]
dein : [dine]
allosww : [swallow]
ehlp : [help]
ehlo : [hole]
deil : [idle]
ehll : [hell]
aemrt : [mater, tamer]
deeffinst : [stiffened]
eegirrst : [register]
adeisswy : [sideways]
beisstttuu : [substitute]
aaccnvy : [vacancy]
dehu : [hued]
bdemoor : [bedroom]
dehs : [shed]
cnostu : [counts]
ckstu : [stuck]
adefhinnosu : [unfashioned]
dehl : [held]
aemst : [teams]
aelltw : [wallet]
aelnnrt : [lantern]
eprsuu : [pursue]
aacilmoopst : [apostolicam]
abeillssu : [sabellius]
delnoprs : [splendor]
bceeeghins : [beseeching]
adehqssu : [squashed]
ehnw : [when]
deku : [duke]
ehnt : [then]
deks : [desk]
glnsu : [slung]
hiintw : [within]
aeerstu : [austere]
eeginorssv : [sovereigns]
efllow : [fellow]
biloosuvy : [obviously]
ehmt : [them]
eeginooprrvw : [overpowering]
cginorss : [crossing]
bgilmmnu : [mumbling]
efmorr : [former]
ehmo : [home]
cdeeinoprv : [providence]
abefortu : [beaufort]
gnsu : [snug]
adeeggrst : [staggered]
aabeellorty : [elaborately]
adenot : [atoned]
aemns : [names, means]
addeflru : [dreadful]
aemnt : [meant]
deorttu : [tutored]
deiopr : [period]
demo : [dome]
afillnpuy : [painfully]
deiops : [poised]
arsst : [stars]
adeeenrtt : [entreated]
abdes : [beads, based]
efhrs : [fresh]
ehov : [hove]
ehor : [hero]
arstw : [straw]
acnnot : [cannot]
ehop : [hope]
acgim : [magic]
deln : [lend]
arstt : [start]
ddeilm : [middle]
behilt : [blithe]
adeisstt : [distaste]
ddeilr : [riddle]
gggilnru : [gurgling]
aenrst : [astern]
giinnnp : [pinning]
horsu : [hours]
aachimrr : [armchair]
horst : [short]
aenrsw : [answer]
deow : [owed]
deos : [does]
aehrrty : [rayther]
aceilnnrtuy : [uncertainly]
cgilnnostu : [consulting]
blluy : [bully]
aaceghlnr : [archangel]
hnortw : [thrown]
aeeginrrtt : [retreating]
fiilmpsy : [simplify]
giinnnw : [winning]
aabeelort : [elaborate]
aenrtu : [nature]
dens : [send, ends]
dent : [tend]
bdginsuu : [subduing]
deno : [done]
dehlru : [hurled]
bddeiors : [disrobed]
glory : [glory]
aabeilm : [amiable]
aegilnqsu : [squealing]
aaceglnorttu : [congratulate]
ccdeefinno : [confidence]
inrtwy : [wintry]
adeeprsu : [persuade]
eeeginnprrst : [representing]
cdeilprsu : [surpliced]
aefmorr : [forearm]
ehty : [they]
ehoss : [shoes]
degins : [design, signed, singed]
ehost : [those]
ehosu : [house]
ehosv : [shove]
ehosw : [whose]
cllnnooy : [connolly]
acgilnnu : [unlacing]
anoprt : [patron]
ceinnosstt : [consistent]
acginr : [caring]
ghiillnss : [shillings]
acginp : [pacing]
aaeinopprrst : [preparations]
eeflt : [fleet]
ddeipp : [dipped]
eglru : [gruel]
eefls : [feels]
aginsty : [staying]
bciistu : [biscuit]
aacdeejltu : [ejaculated]
aabeglnprsu : [ungraspable]
iimsss : [missis]
delov : [loved]
delow : [lowed]
dginost : [dotings]
cdghiin : [chiding]
deloy : [doyle]
ghilnow : [howling]
desu : [used]
adelmprt : [trampled]
eirtw : [write]
acgilnps : [clasping]
aginssy : [sayings]
acgilnpp : [clapping]
fills : [fills]
aellry : [really]
aghlsty : [ghastly]
deffpu : [puffed]
adefggl : [flagged]
derw : [drew]
abcdeeelrt : [celebrated]
deru : [rude]
aaeegrv : [average]
addeehrt : [threaded]
ehors : [shore]
ehort : [other]
acdeilmnop : [complained]
aellru : [laurel]
adegnorsu : [dangerous]
aillnosuv : [villanous]
beeiilnprssxy : [inexpressibly]
adiinn : [indian]
accdehilmops : [accomplished]
aillnpy : [plainly]
deiimnprt : [imprinted]
eirrv : [river]
deefllw : [wellfed]
efiln : [elfin]
ghiilnttw : [whittling]
eeopprsss : [oppresses]
amny : [many]
mppu : [pump]
cdeemmnor : [recommend]
amnu : [unam]
deffno : [offend]
egiinrrt : [retiring]
adeiprr : [parried]
adeiprs : [despair, praised]
bnosttu : [buttons]
acgirs : [cigars]
aellps : [lapels]
ehops : [hopes]
aimnnos : [mansion]
deehrsu : [ushered]
eforruv : [fervour]
aiikmnn : [manikin]
accgikln : [clacking]
aaiillt : [liliata]
cersu : [curse]
deettw : [wetted]
cefmoorrt : [comforter]
enttwy : [twenty]
elnntu : [tunnel]
eerssv : [verses]
acilloty : [locality]
ginostw : [stowing]
dllouy : [loudly]
agillnosww : [swallowing]
aglpuy : [plaguy]
eeimmors : [memories]
ceghiorstt : [gottsreich]
acefilstu : [faculties]
adfhlnsu : [handfuls]
acimnort : [romantic]
eefprr : [prefer]
nstu : [nuts]
aeeellmnt : [elemental]
lloswy : [slowly]
eegimnt : [meeting]
egiinnosu : [ingenious]
eegimns : [seeming]
bhiirst : [british]
bnrtu : [burnt]
eerstt : [street]
amrs : [arms, mars]
aacdeinr : [radiance]
aaiilnt : [italian]
aeegnv : [geneva]
accgiknr : [cracking]
cdors : [cords]
cdorw : [crowd]
ceruv : [curve]
abehlnoor : [honorable]
egilmps : [glimpse]
eimnnot : [mention]
amrw : [warm]
ceiijnstu : [injustice]
delmo : [model]
amry : [mary, army]
dggilnos : [lodgings]
aadlnu : [landau]
dellw : [dwell]
aehimnsstu : [enthusiasm]
aaehiiortttuv : [authoritative]
lmpu : [lump]
aeelrsty : [easterly]
allsst : [stalls]
eeimmns : [immense]
eillnss : [illness]
eeghinwz : [wheezing]
addhooossww : [woodshadows]
aeinptt : [patient]
aarry : [array]
amss : [mass]
ciiintvy : [vicinity]
aeinotvx : [vexation]
deeiqrru : [required]
aacdeiosst : [associated]
blmosy : [symbol]
eeenprrsst : [represents]
aaabelnnrrtuw : [unwarrantable]
aceginpr : [capering]
amsw : [swam]
aceginps : [escaping]
aeegrs : [grease]
osttu : [stout]
hipss : [ships]
cdeeginoprs : [proceedings]
deeiqruv : [quivered]
aeeilntttvy : [attentively]
einrttw : [written]
aacehmmnnrt : [merchantman]
acdeiqttu : [acquitted]
aabcdennu : [abundance]
dhiilnrsww : [whirlwinds]
cceehkkorrw : [checkerwork]
bghilrty : [brightly]
addnorsww : [downwards]
abeill : [liable]
beegghiilmrrst : [thimbleriggers]
ailorsty : [solitary]
bmoos : [bosom]
aeelrst : [relates]
cdemmooor : [commodore]
aeelrsv : [several]
egiinnoqstu : [questioning]
ccddeennos : [condescend]
defhlsu : [flushed]
egilmmr : [glimmer]
bmoor : [broom]
